,hash,trans_size,sum(in_value),hash,size,sum(out_value),trans_fees,trans_fees_2
0,05109b4964be7bbbb7c52c307405ff49e0d331afd036fefc53b17ccc9a8276ec,277,55292953,05109b4964be7bbbb7c52c307405ff49e0d331afd036fefc53b17ccc9a8276ec,277,55283603,9350,33.75
1,265d798bd11d207152974c1f135bf3baab666017b4b0ba545666900c24a88368,357,7868827,265d798bd11d207152974c1f135bf3baab666017b4b0ba545666900c24a88368,357,7866317,2510,7.03
2,c2ab163210109dba5669af642835e6249a49f800a6ea7841fabda736f5f08440,381,1045607,c2ab163210109dba5669af642835e6249a49f800a6ea7841fabda736f5f08440,381,1040270,5337,14.01
3,d69f00f2cccb64a077823273d4195b9d3725f922ac6c1a58a52d1ec3ff0d5817,192,318825,d69f00f2cccb64a077823273d4195b9d3725f922ac6c1a58a52d1ec3ff0d5817,192,315939,2886,15.03
4,e8b40033964019b8aa515ed88a297917c6d18ea67fdb4c598486de5918a1f95d,191,1729400,e8b40033964019b8aa515ed88a297917c6d18ea67fdb4c598486de5918a1f95d,191,1727094,2306,12.07
5,258404c49f49f8ec15e3ba4533c6542223fd81e5a97812a25f8f6af8a8fe7aea,372,298924,258404c49f49f8ec15e3ba4533c6542223fd81e5a97812a25f8f6af8a8fe7aea,372,293464,5460,14.68
6,3ce92cc2838b86b6d8bb4c671460895ab9d73b433c2eb19d432697a947fbb184,506,100114,3ce92cc2838b86b6d8bb4c671460895ab9d73b433c2eb19d432697a947fbb184,506,90936,9178,18.14
7,4b5c3a6d3b19f199a463d7a6bfd0108e84a1915742c0baaa7be39f551f5bbf05,191,1801829,4b5c3a6d3b19f199a463d7a6bfd0108e84a1915742c0baaa7be39f551f5bbf05,191,1800821,1008,5.28
8,82dfe359d1f369c1946d8e1f759f877efe8cd79bcf4c547ed41ec78cb73182ba,224,3477359,82dfe359d1f369c1946d8e1f759f877efe8cd79bcf4c547ed41ec78cb73182ba,224,3473667,3692,16.48
9,a973d4edd66ca52c62ca9391f2d698d86bac1d95878fc4455a89479bae9de1fa,234,1153518,a973d4edd66ca52c62ca9391f2d698d86bac1d95878fc4455a89479bae9de1fa,234,1151528,1990,8.5
10,da5b5f26b60d24d89d32d4fdd8240c6d6c6a6c436cd03bd41e4c81aa898f480c,193,3458227,da5b5f26b60d24d89d32d4fdd8240c6d6c6a6c436cd03bd41e4c81aa898f480c,193,3455303,2924,15.15
11,16e462708ee8da8127c927f57ba79d87c11052a069f1096789e17f01136aefa4,224,8342761,16e462708ee8da8127c927f57ba79d87c11052a069f1096789e17f01136aefa4,224,8335723,7038,31.42
12,18e4e9b0a380f22d9333f3c964484ae8498a3f9eb3f9b2a3e4ec7ba15698fd53,223,6157053,18e4e9b0a380f22d9333f3c964484ae8498a3f9eb3f9b2a3e4ec7ba15698fd53,223,6153943,3110,13.95
13,7b0b23c559eda2b503aca36c149934a5682c99f25cf8c1465fcbefcde0d07059,223,17585498,7b0b23c559eda2b503aca36c149934a5682c99f25cf8c1465fcbefcde0d07059,223,17582092,3406,15.27
14,9988e348b4e2f46582866eca29385293e01eb146b528dc3e175e1de2c7351768,192,319582,9988e348b4e2f46582866eca29385293e01eb146b528dc3e175e1de2c7351768,192,316696,2886,15.03
15,c0539b178f3be975e77802d0c0591e8bcb55ea8b37fa1d5aaa24ec7a94537b0f,247,94920299,c0539b178f3be975e77802d0c0591e8bcb55ea8b37fa1d5aaa24ec7a94537b0f,247,94918979,1320,5.34
16,d96eca129b6924e9d03d92fe96512c1eca029565861a461427c7ee7abaaf6b44,222,352826,d96eca129b6924e9d03d92fe96512c1eca029565861a461427c7ee7abaaf6b44,222,349186,3640,16.4
17,dab72e6e7d1564305672cf52a4c71f7eab475627fb248f3597773abf0fd652ea,225,95730075,dab72e6e7d1564305672cf52a4c71f7eab475627fb248f3597773abf0fd652ea,225,95724027,6048,26.88
18,dbeecbb19150d57ae2f69605c60add5b7f9ffc3490f8d14b68f5d976712af735,222,1363313,dbeecbb19150d57ae2f69605c60add5b7f9ffc3490f8d14b68f5d976712af735,222,1361315,1998,9
19,4b9295b6fb6b8cd40169101b807e556e9a6e3f48c673a6507b2750453c9309c2,223,1593059,4b9295b6fb6b8cd40169101b807e556e9a6e3f48c673a6507b2750453c9309c2,223,1589393,3666,16.44
20,b4d18ccc32db8f0249db8360946c8df5ed8c5e6012881fc2d8b60e5690eb60e1,374,452714,b4d18ccc32db8f0249db8360946c8df5ed8c5e6012881fc2d8b60e5690eb60e1,374,451202,1512,4.04
21,b9c88a92b3442c7094f535a8ae96d494f74c6f0a45b8e48cce2fdf649ae0bd25,371,3288578,b9c88a92b3442c7094f535a8ae96d494f74c6f0a45b8e48cce2fdf649ae0bd25,371,3287117,1461,3.94
22,cfa4f432e774b7271297fda058b611e0e2a03a3440ec025fdba50eaf4af2f794,223,142628,cfa4f432e774b7271297fda058b611e0e2a03a3440ec025fdba50eaf4af2f794,223,138962,3666,16.44
23,4a27935a4e7c8a4dcb6d8064758d1526a0585da7b28ed49960f365304414cf2e,189,312920,4a27935a4e7c8a4dcb6d8064758d1526a0585da7b28ed49960f365304414cf2e,189,303943,8977,47.5
24,6d456388d8e3d4a53373e60542f0df0fa4e5c20651fd696af7dbb43a948fcdd5,223,4110578,6d456388d8e3d4a53373e60542f0df0fa4e5c20651fd696af7dbb43a948fcdd5,223,4108061,2517,11.29
25,90f987f0f272b3d0dff2780f203e6d0351da7107c0772ec7c19b6afbd254323e,154,5000,90f987f0f272b3d0dff2780f203e6d0351da7107c0772ec7c19b6afbd254323e,154,4384,616,4
26,01287536bb76a2e3e8167b87ab59aa86c311c75e135676c516580cdbdd700521,191,1599216,01287536bb76a2e3e8167b87ab59aa86c311c75e135676c516580cdbdd700521,191,1596356,2860,14.97
27,3aef0ba5c095fac63e123c800b5e51a928ae9d4b9bad60659d999e09667d4805,533,8013990,3aef0ba5c095fac63e123c800b5e51a928ae9d4b9bad60659d999e09667d4805,533,7986390,27600,51.78
28,7c68be6023afa127073aa23d50a6bdf8e52b147a3a37a8700dd55c44e624c58f,223,19287886,7c68be6023afa127073aa23d50a6bdf8e52b147a3a37a8700dd55c44e624c58f,223,19283804,4082,18.3
29,bd9654ade694f6fc3c75f5c7ce7f5374bbd33fc3beca0c0a665aba42f65640bc,492,2875144,bd9654ade694f6fc3c75f5c7ce7f5374bbd33fc3beca0c0a665aba42f65640bc,492,2868670,6474,13.16
30,fe86ae6d1a48a5a0dbde583c6b7cd959405920ad68ac544269fcc59df3dbcf80,248,31693616,fe86ae6d1a48a5a0dbde583c6b7cd959405920ad68ac544269fcc59df3dbcf80,248,31689365,4251,17.14
31,6417378a1da008c85b3fd60836e16285634a0bddde0cec16976e5f099fa6169f,492,406493,6417378a1da008c85b3fd60836e16285634a0bddde0cec16976e5f099fa6169f,492,400019,6474,13.16
32,828bc5e2d9b106c7283b2c73afbf4d56316fc58c1ee97377b059b60325099f43,226,97381,828bc5e2d9b106c7283b2c73afbf4d56316fc58c1ee97377b059b60325099f43,226,96381,1000,4.42
33,87a62c03c908915f80b55bc8074c513d8d3c5db6726b161252556bc3846ebf70,359,7000,87a62c03c908915f80b55bc8074c513d8d3c5db6726b161252556bc3846ebf70,359,5344,1656,4.61
34,c1758b38af38da0d5a81166999deaf9faa4c3e225b59eeba9557627f438b0515,223,263832,c1758b38af38da0d5a81166999deaf9faa4c3e225b59eeba9557627f438b0515,223,262846,986,4.42
35,c82805161f4fa0dbbd06d3db12e1a7116f73c1923335cf84b9215d4adf387762,371,302401,c82805161f4fa0dbbd06d3db12e1a7116f73c1923335cf84b9215d4adf387762,371,297353,5048,13.61
36,f196824f13c116b932c00619dea390fd5f61a86c2e732640dd8f4ec5dd5bd500,381,22911749,f196824f13c116b932c00619dea390fd5f61a86c2e732640dd8f4ec5dd5bd500,381,22902387,9362,24.57
37,38dcae7c4840c780d864b664bfa88ae94f6005d03a4e797936a7eada42d39524,192,180694,38dcae7c4840c780d864b664bfa88ae94f6005d03a4e797936a7eada42d39524,192,178966,1728,9
38,d85a84eb4dd80cc956136c9a2e0a38608d2a5a30000dab9ee7c27e7df30b8d64,194,1100000,d85a84eb4dd80cc956136c9a2e0a38608d2a5a30000dab9ee7c27e7df30b8d64,194,1088474,11526,59.41
39,ea91359dc14fa8256d0469daad5f73062da18327d646be1ff67976aae90db6c7,506,97124,ea91359dc14fa8256d0469daad5f73062da18327d646be1ff67976aae90db6c7,506,87946,9178,18.14
40,fedbf6a57649dda469c786d9dd2be8ceaf4f9f80d0b2fcb15097e95c59f03c94,154,2500,fedbf6a57649dda469c786d9dd2be8ceaf4f9f80d0b2fcb15097e95c59f03c94,154,1884,616,4
41,0c827a2c6ab3702c4bc1f2cdf8a605b0d0ee04c6ada0c038a52b4b8a49338c76,154,2500,0c827a2c6ab3702c4bc1f2cdf8a605b0d0ee04c6ada0c038a52b4b8a49338c76,154,1884,616,4
42,41322b8a76cd86f6d6940ea67760fa13b45489f6b1350a0c341ec59e289c37f0,256,47983196,41322b8a76cd86f6d6940ea67760fa13b45489f6b1350a0c341ec59e289c37f0,256,47978471,4725,18.46
43,43734b35b3196b98c155e7b2d8d61c3540d717fb49732bd6e8ff7dc479825c8f,462,433953,43734b35b3196b98c155e7b2d8d61c3540d717fb49732bd6e8ff7dc479825c8f,462,425838,8115,17.56
44,57f213ec7d63795e4b1258904163e2762b9ac1464ea3da9c3ac26fcd427f7fb4,225,87589695,57f213ec7d63795e4b1258904163e2762b9ac1464ea3da9c3ac26fcd427f7fb4,225,87585951,3744,16.64
45,6cedc2c3ad6660ab8d056d9e9d21cd9123f6b9d56997542b7117a46f65d55402,222,248952,6cedc2c3ad6660ab8d056d9e9d21cd9123f6b9d56997542b7117a46f65d55402,222,246435,2517,11.34
46,cec81a54942a153f1898b2a989621ab373e5c291fa301b6af3aac216696385b2,226,738642,cec81a54942a153f1898b2a989621ab373e5c291fa301b6af3aac216696385b2,226,734898,3744,16.57
47,fa4001ec51732205c7cb9f5036581811420ca5a8cf74603e8b8e81918cf485a3,224,958144,fa4001ec51732205c7cb9f5036581811420ca5a8cf74603e8b8e81918cf485a3,224,949740,8404,37.52
48,c2a397511668750fd0703e4ab8510ceffb5ce071b534074aea75c2487a95f7d7,279,1586299,c2a397511668750fd0703e4ab8510ceffb5ce071b534074aea75c2487a95f7d7,279,1581182,5117,18.34
49,290204f68e42bdd027258efacc889622b9bf3a9ec8f6bbb1d73b4dbbbd4ad812,222,1360528,290204f68e42bdd027258efacc889622b9bf3a9ec8f6bbb1d73b4dbbbd4ad812,222,1357000,3528,15.89
50,8a9d6155dc56a3fbf793279744cb1c5431de471934f6f43470fd8bcaba3ea129,224,3578350,8a9d6155dc56a3fbf793279744cb1c5431de471934f6f43470fd8bcaba3ea129,224,3574671,3679,16.42
51,182f8bdbf907c7e9c73e1ae9ef2f1be54a465573dbcbe9529f508381b865b643,373,16159576,182f8bdbf907c7e9c73e1ae9ef2f1be54a465573dbcbe9529f508381b865b643,373,16154142,5434,14.57
52,39732c1e7f7ec3a491e62192fe2f603d02a4a73bae77980a58fd5a59285a11f9,162,10000,39732c1e7f7ec3a491e62192fe2f603d02a4a73bae77980a58fd5a59285a11f9,162,9319,681,4.2
53,64ca9c64ea551c5c1e89764e1606f348314b0b4bb65a8af7f7d90ed70c0420fe,222,365907,64ca9c64ea551c5c1e89764e1606f348314b0b4bb65a8af7f7d90ed70c0420fe,222,359955,5952,26.81
54,857fc4e01c1eb5aa7d4c262dbdc2f29fb5fa75a95fd926b578edb0779a662677,195,388014,857fc4e01c1eb5aa7d4c262dbdc2f29fb5fa75a95fd926b578edb0779a662677,195,384042,3972,20.37
55,8eca07d753efe3adf5565af4add567c44864c2ef00ebea51cd16fefbe1819d4a,224,1440615,8eca07d753efe3adf5565af4add567c44864c2ef00ebea51cd16fefbe1819d4a,224,1439629,986,4.4
56,5e7e9c5ecf2be8d633599af5404b9adfaf6775de0ec1ba57d489795b99eedf50,234,2784617,5e7e9c5ecf2be8d633599af5404b9adfaf6775de0ec1ba57d489795b99eedf50,234,2782854,1763,7.53
57,76b46cf4f359ec35852f8cbaa864f3a93e98d2d802df9a89829117d3cf070f57,224,8075400,76b46cf4f359ec35852f8cbaa864f3a93e98d2d802df9a89829117d3cf070f57,224,8071318,4082,18.22
58,8dfc223e8520083ba9ed1dcf3e9b8f87b47e1084c4ff3e32b3c31b022a169880,374,3958000,8dfc223e8520083ba9ed1dcf3e9b8f87b47e1084c4ff3e32b3c31b022a169880,374,3950176,7824,20.92
59,93b264578ec6108ed260f99a4596ecbdcd009a09fea37cb94649f39a22d2138a,1083,6105495,93b264578ec6108ed260f99a4596ecbdcd009a09fea37cb94649f39a22d2138a,1083,6097047,8448,7.8
60,b5d55b91eb2e591d0d62da4ddc2316c5652048749df1d504ed8e76eb3e32f2a0,225,180128738,b5d55b91eb2e591d0d62da4ddc2316c5652048749df1d504ed8e76eb3e32f2a0,225,180123240,5498,24.44
61,f50e9bdb046be1b9aca3091fc81216aad8ec6a917ffc7a6bb3b10c1126eddeb7,254,567956224,f50e9bdb046be1b9aca3091fc81216aad8ec6a917ffc7a6bb3b10c1126eddeb7,254,567951502,4722,18.59
62,e0a27ff77f6413025ebfbca08b8fda1a36e9498a6b628b8ab06bf8dd886cae39,375,1062788,e0a27ff77f6413025ebfbca08b8fda1a36e9498a6b628b8ab06bf8dd886cae39,375,1061339,1449,3.86
63,507357070840b07d02385d0de37993efc1a845cd06c36112844b9512d01921d9,403,457795,507357070840b07d02385d0de37993efc1a845cd06c36112844b9512d01921d9,403,454766,3029,7.52
64,801ec20e537e3b7339fe8a742ec7ad64ff830cf374e64eadf589114ac14bb5ef,225,8019432,801ec20e537e3b7339fe8a742ec7ad64ff830cf374e64eadf589114ac14bb5ef,225,8015688,3744,16.64
65,90bdaf7f5d1d46d42449a330f8b4345f234ad8fcea70c2e95203a0817d0e4323,5128,45058717,90bdaf7f5d1d46d42449a330f8b4345f234ad8fcea70c2e95203a0817d0e4323,5128,45007813,50904,9.93
66,bcf982ef189a09878c790c42b20636307df0a10165e3ea49f5b309d6eeee52fb,254,398833418,bcf982ef189a09878c790c42b20636307df0a10165e3ea49f5b309d6eeee52fb,254,398831688,1730,6.81
67,348b17284f4b1f6e13bd70791df9010805a5e7c33308667f4411f3353c9d36f3,194,22877038,348b17284f4b1f6e13bd70791df9010805a5e7c33308667f4411f3353c9d36f3,194,22873775,3263,16.82
68,5782629de40e0d84c7003e6f1cbb77c466f4de5c674e65ab8334f7980a1a1ea3,693,190917865,5782629de40e0d84c7003e6f1cbb77c466f4de5c674e65ab8334f7980a1a1ea3,693,190915648,2217,3.2
69,5a5f02eaf02725b47a78e8d47ec819d793d134ba5f08342bde789444dc27fe43,383,47228973,5a5f02eaf02725b47a78e8d47ec819d793d134ba5f08342bde789444dc27fe43,383,47223581,5392,14.08
70,8f9a8110fe4c38c73153a27b025b5a7b9cca3ed1555e3e0127f6d2bfe67f9e95,432,1528956,8f9a8110fe4c38c73153a27b025b5a7b9cca3ed1555e3e0127f6d2bfe67f9e95,432,1527424,1532,3.55
71,d8736e62a588192bedf3223fd7ebb0335f91fb8b1c7b4fc91f08386e49f60904,22505,44229,d8736e62a588192bedf3223fd7ebb0335f91fb8b1c7b4fc91f08386e49f60904,22505,10047,34182,1.52
72,6b328a8147e553a0d452622cda31373596524f8388fb23b19415923d44884298,491,451626,6b328a8147e553a0d452622cda31373596524f8388fb23b19415923d44884298,491,447610,4016,8.18
73,6fb8cde9b23952a4c2e620de1460b68bfc6fad062e887b32268eda7f45c18856,551,42173052,6fb8cde9b23952a4c2e620de1460b68bfc6fad062e887b32268eda7f45c18856,551,42162242,10810,19.62
74,f81fb2382c5a019e0ab913abdf6ab02786f393e4221b1201eed396addccd9944,370,4669369,f81fb2382c5a019e0ab913abdf6ab02786f393e4221b1201eed396addccd9944,370,4667923,1446,3.91
75,2632bf0da591468a0054d68826b615405769cdacf9c18ae74dac369fd84727fa,223,67147679,2632bf0da591468a0054d68826b615405769cdacf9c18ae74dac369fd84727fa,223,67146543,1136,5.09
76,2a461b4c1585bc235eccebf3adac6e28f78f1387e0d9a072a8d31c10cd75e8c1,8860,12373120,2a461b4c1585bc235eccebf3adac6e28f78f1387e0d9a072a8d31c10cd75e8c1,8860,12243910,129210,14.58
77,2c3f7404c482f0092d993a1bc5bd2649936ebc0265163481566e393faad7173f,1073,735238,2c3f7404c482f0092d993a1bc5bd2649936ebc0265163481566e393faad7173f,1073,717958,17280,16.1
78,6a7973b2dd9de58b6fefd75f5b43a6cd2c959afc5ee4b3c1f7bd6a23d5da582f,192,1215258,6a7973b2dd9de58b6fefd75f5b43a6cd2c959afc5ee4b3c1f7bd6a23d5da582f,192,1203936,11322,58.97
79,70e161f1307c71613998beccfe1667262f7868f0fb61e5bf3731f2f72c522c45,196,10000,70e161f1307c71613998beccfe1667262f7868f0fb61e5bf3731f2f72c522c45,196,9262,738,3.77
80,71242fe506236e400c59455ade4a61f959d2d67a730c2725b4b0075b6367d398,1344,10586218713,71242fe506236e400c59455ade4a61f959d2d67a730c2725b4b0075b6367d398,1344,10586188123,30590,22.76
81,7d2184158a7f3d59cb945737c11beb13c3f2e739f172483f43e473a81e3fd736,225,454194,7d2184158a7f3d59cb945737c11beb13c3f2e739f172483f43e473a81e3fd736,225,449658,4536,20.16
82,8ad5195db3b20e101380b42f4fcfd7d2512b2bdd35a8605447c3d29804f4a226,407,14539761,8ad5195db3b20e101380b42f4fcfd7d2512b2bdd35a8605447c3d29804f4a226,407,14533821,5940,14.59
83,9e0ead1091aeb864712b797dc567686fb417914bf7a6ba10eda772783cf31622,506,92590,9e0ead1091aeb864712b797dc567686fb417914bf7a6ba10eda772783cf31622,506,83414,9176,18.13
84,ab610fc5a61863b2bac64a039b43f667a182aab9a798c8e9786631b0a8c9639b,462,629646,ab610fc5a61863b2bac64a039b43f667a182aab9a798c8e9786631b0a8c9639b,462,622131,7515,16.27
85,ac24a710bcfbe2c0ebf6b0a824d75a8208f8e3ff2648f6408e37ee129b9a0106,226,226968,ac24a710bcfbe2c0ebf6b0a824d75a8208f8e3ff2648f6408e37ee129b9a0106,226,223376,3592,15.89
86,cb0c0e751a1011a125bb38bb16d437b1c9ab918a957bfa4770998abb4f1aa56e,223,1767449,cb0c0e751a1011a125bb38bb16d437b1c9ab918a957bfa4770998abb4f1aa56e,223,1764932,2517,11.29
87,12215665140b951d29a78b8be290ebd5c79e8bf3ef346afe2a3094a6c56573c9,195,108432,12215665140b951d29a78b8be290ebd5c79e8bf3ef346afe2a3094a6c56573c9,195,107648,784,4.02
88,272a8fe1af4048369545cd07429c4208a5c6e79176294ce0390fdccce5e5f2ab,191,3368459,272a8fe1af4048369545cd07429c4208a5c6e79176294ce0390fdccce5e5f2ab,191,3363659,4800,25.13
89,445b849600359395a49c9a1da13a62a345c39a42fe01ecacb17fecbf75515629,224,31747,445b849600359395a49c9a1da13a62a345c39a42fe01ecacb17fecbf75515629,224,27665,4082,18.22
90,08ceb1ea9be342c6967ffb179efac7c0de972735c79b16d6d46c20787e1ec609,631,3882407,08ceb1ea9be342c6967ffb179efac7c0de972735c79b16d6d46c20787e1ec609,631,3872231,10176,16.13
91,161156eb3261dbf431736a792f3dee1efdb67107a02e12eeb2ab1c49ad7d6fc7,223,53086528,161156eb3261dbf431736a792f3dee1efdb67107a02e12eeb2ab1c49ad7d6fc7,223,53085648,880,3.95
92,1363a2cad9b35d8384ae6f003fa97d2d47d1913c6626e1612e1892927f785e60,224,7938817,1363a2cad9b35d8384ae6f003fa97d2d47d1913c6626e1612e1892927f785e60,224,7934735,4082,18.22
93,25d66574464d64f16c514bc437da81a9e05cb92113d509bcc5b407baa5938516,506,110116,25d66574464d64f16c514bc437da81a9e05cb92113d509bcc5b407baa5938516,506,100938,9178,18.14
94,bb2a6ea66656815134a5cf7c2864981230ef71616db93c5b97d6635f59fb5137,195,1057335,bb2a6ea66656815134a5cf7c2864981230ef71616db93c5b97d6635f59fb5137,195,1054397,2938,15.07
95,0c2012055e05a16baf274077a2cbd158bd793afe58044953b8844748938e84fb,221,17946877,0c2012055e05a16baf274077a2cbd158bd793afe58044953b8844748938e84fb,221,17940468,6409,29
96,80de94364f23255a63ac29358c8ae34574a9c9724ffc6ff976a843c7b9b000d9,462,3912420,80de94364f23255a63ac29358c8ae34574a9c9724ffc6ff976a843c7b9b000d9,462,3904305,8115,17.56
97,b051bdfd1214e6d8ceaeebed6090314527dd71f9e2867f800b651f9499790b56,225,705431,b051bdfd1214e6d8ceaeebed6090314527dd71f9e2867f800b651f9499790b56,225,699479,5952,26.45
98,10069bcb5fc6422e411610806b97568b2c6962b687f8c0ac06b6a14016ca00f2,222,2585781,10069bcb5fc6422e411610806b97568b2c6962b687f8c0ac06b6a14016ca00f2,222,2582671,3110,14.01
99,4a47cafad1275d237fdcca10e7d456032ea59ddc086a88f8f0be0aa66b5c7e7f,222,867847,4a47cafad1275d237fdcca10e7d456032ea59ddc086a88f8f0be0aa66b5c7e7f,222,864737,3110,14.01
100,5205ad4bc3ae1f865c3b9fb6d468dba11c1cd5afe4b07966bfc5d519ff788a40,462,288695,5205ad4bc3ae1f865c3b9fb6d468dba11c1cd5afe4b07966bfc5d519ff788a40,462,280580,8115,17.56
101,a040c71981519fefb691db0289b5821fa07da583e922e69e4a2247aafbd10b90,522,66400,a040c71981519fefb691db0289b5821fa07da583e922e69e4a2247aafbd10b90,522,59120,7280,13.95
102,aea5c2444b4cb359fb9b9ab749d6e2c4fb1840f15dc4ced73a2396b432571128,223,4260907084,aea5c2444b4cb359fb9b9ab749d6e2c4fb1840f15dc4ced73a2396b432571128,223,4260902682,4402,19.74
103,e691cc94020dd4f4e6f522e9e113febd83b53dfb28ad6e640516cfe6cee796ca,223,10243910,e691cc94020dd4f4e6f522e9e113febd83b53dfb28ad6e640516cfe6cee796ca,223,10242931,979,4.39
104,296fc350756794e06890fb2565eb83b1f8b953b20aa8e947e6716faaaebd194e,222,11715256,296fc350756794e06890fb2565eb83b1f8b953b20aa8e947e6716faaaebd194e,222,11714277,979,4.41
105,29deeaae57482faf7f11d8cbf1a8bb0a00419159ab33df66ad4b036f9105d280,339,321903,29deeaae57482faf7f11d8cbf1a8bb0a00419159ab33df66ad4b036f9105d280,339,317275,4628,13.65
106,6332cfe8255b50fe58a87e04ef58d73e6c5aa3bb8bdf10f8c91bf7ff62d0f13f,193,260960,6332cfe8255b50fe58a87e04ef58d73e6c5aa3bb8bdf10f8c91bf7ff62d0f13f,193,256860,4100,21.24
107,6914832aa6b631b975edc11f2f9f5d1e187fcb266c5a2629afcced659d941ebe,506,97096,6914832aa6b631b975edc11f2f9f5d1e187fcb266c5a2629afcced659d941ebe,506,87918,9178,18.14
108,909f24c5807786a5f3a4da9ba4af23f1090303669b43286b2d2440a9892e9a14,188,178000,909f24c5807786a5f3a4da9ba4af23f1090303669b43286b2d2440a9892e9a14,188,176834,1166,6.2
109,c00e96fcdbd724f43249c1c648324289b24f7d7bf8e9652a76c3365d700d4250,234,1145357,c00e96fcdbd724f43249c1c648324289b24f7d7bf8e9652a76c3365d700d4250,234,1143047,2310,9.87
110,e8f0c4b3ca6f98be2d24b07ae97930cd65e83a21a3ec84e25cde084f45b32bb5,224,150725,e8f0c4b3ca6f98be2d24b07ae97930cd65e83a21a3ec84e25cde084f45b32bb5,224,144901,5824,26
111,49e1981fa30ef9053f82600c575f74727f31363c18798d7c964bb1a73afadb12,151,2500,49e1981fa30ef9053f82600c575f74727f31363c18798d7c964bb1a73afadb12,151,2047,453,3
112,997fdb43cdb0f06c008cd84676425487ebc2fe264987946ce9a309f817d25102,223,4965157,997fdb43cdb0f06c008cd84676425487ebc2fe264987946ce9a309f817d25102,223,4963596,1561,7
113,d5a4b71d4ef3b679fb283b681f02fb7d05b2eec4022aa08400fa0359aac1fc05,492,906984,d5a4b71d4ef3b679fb283b681f02fb7d05b2eec4022aa08400fa0359aac1fc05,492,900510,6474,13.16
114,dc4155cf7e3e310c443cc81811c062c50015e8b80f9a34985922725deeeff6a2,372,239719,dc4155cf7e3e310c443cc81811c062c50015e8b80f9a34985922725deeeff6a2,372,232180,7539,20.27
115,9e4fd0700acd9d8911a6403ea7e8256e32df34284d907134deddf22a6b111387,224,6223736,9e4fd0700acd9d8911a6403ea7e8256e32df34284d907134deddf22a6b111387,224,6220044,3692,16.48
116,a0468a9971644631d01d6bb293656246f8a3e7d089fb148ce194b3032fcf7f68,226,74109,a0468a9971644631d01d6bb293656246f8a3e7d089fb148ce194b3032fcf7f68,226,70365,3744,16.57
117,09edb8fbf910a9334a7a26a16f0ac6af88dc8edfcfeb8cc7986b3f8afff97d53,506,100114,09edb8fbf910a9334a7a26a16f0ac6af88dc8edfcfeb8cc7986b3f8afff97d53,506,90936,9178,18.14
118,965ece6f5c85fc1bfbe7c6c6cea0d553e791e4444b173eab3e759eb8d65691a4,226,35599,965ece6f5c85fc1bfbe7c6c6cea0d553e791e4444b173eab3e759eb8d65691a4,226,34570,1029,4.55
119,bbcf30907f10458451c6e3f12ae984f39a4869d6172f95a3d154776bea7ca60f,195,4864446,bbcf30907f10458451c6e3f12ae984f39a4869d6172f95a3d154776bea7ca60f,195,4859646,4800,24.62
120,df82ca640e4f4f017866c9fb5cc995a557c8f8f8f07408d2651c9d10ef40b67a,154,2500,df82ca640e4f4f017866c9fb5cc995a557c8f8f8f07408d2651c9d10ef40b67a,154,1884,616,4
121,056bd2c6f9ba550e04ee5c637cd60c02a9696a64b73227889864da1b720651ea,222,270335,056bd2c6f9ba550e04ee5c637cd60c02a9696a64b73227889864da1b720651ea,222,269356,979,4.41
122,1b3f6f61bb9e81059538dc9d16a66854573fe79675b5c4c3f140573ae0758929,191,1121400,1b3f6f61bb9e81059538dc9d16a66854573fe79675b5c4c3f140573ae0758929,191,1117143,4257,22.29
123,2ac6e2b35cf65525a0025a7c10ff33e3b4405e0187d3862ba9ddcd621c573e73,223,1604497,2ac6e2b35cf65525a0025a7c10ff33e3b4405e0187d3862ba9ddcd621c573e73,223,1600415,4082,18.3
124,3d9aadd6c6b7a79b2e4eba1a2801c2e8201fc419f762f8e504ba927377a19cdb,224,280712,3d9aadd6c6b7a79b2e4eba1a2801c2e8201fc419f762f8e504ba927377a19cdb,224,279194,1518,6.78
125,8088383ecc66f9f70b69da7a0484c4b2801e4716d99cab01ea3b04796e0e4850,222,577781,8088383ecc66f9f70b69da7a0484c4b2801e4716d99cab01ea3b04796e0e4850,222,574373,3408,15.35
126,53165a2bd31c03c2f40e9a8f98acfa71b43f430c9b4ce0787f30353ec1db5096,188,94607,53165a2bd31c03c2f40e9a8f98acfa71b43f430c9b4ce0787f30353ec1db5096,188,89807,4800,25.53
127,6f1a02ab9e3f43ac82cd6c7122a69f48816f6f055930378cf1e10d4b455577c1,669,472129,6f1a02ab9e3f43ac82cd6c7122a69f48816f6f055930378cf1e10d4b455577c1,669,464967,7162,10.71
128,7537cc920f1aa4350e0a0ed42cbe1f12eaf66497699e4f345a454ca5c2fe2022,2664,7454095,7537cc920f1aa4350e0a0ed42cbe1f12eaf66497699e4f345a454ca5c2fe2022,2664,7427344,26751,10.04
129,7c929072fb58a30875ad1b18bcb319bda822daeaf07f5bb8b370357e57d75804,249,1034647,7c929072fb58a30875ad1b18bcb319bda822daeaf07f5bb8b370357e57d75804,249,1032535,2112,8.48
130,b3fe545dcf597cc7e51b47326f388cc8aea30872e265fdc6e7898e53bbc77957,341,399387,b3fe545dcf597cc7e51b47326f388cc8aea30872e265fdc6e7898e53bbc77957,341,398027,1360,3.99
131,e81ed440d7ce78ba24a346fbfa8fda74f11ace202f418898661cfce98e3d73b1,225,2188283,e81ed440d7ce78ba24a346fbfa8fda74f11ace202f418898661cfce98e3d73b1,225,2185403,2880,12.8
132,3386912f1bf052ab5cf932406252c2650a7061854cb1238686c87c6f2cee124d,519,5462273,3386912f1bf052ab5cf932406252c2650a7061854cb1238686c87c6f2cee124d,519,5460344,1929,3.72
133,409d87275e8d037b27024301f9f2d63350ee2216ef45524436925013cb7ec682,225,7638813,409d87275e8d037b27024301f9f2d63350ee2216ef45524436925013cb7ec682,225,7636091,2722,12.1
134,45c47e7910ae9141e33235d18592708d8bf55147e5f3370935beb41a0c5608c4,410,22067397,45c47e7910ae9141e33235d18592708d8bf55147e5f3370935beb41a0c5608c4,410,22059853,7544,18.4
135,a03c4c0832cd39a64ab8356a9a32dff8cdcfc4efa925bfc743d460b42707d3f7,225,351900,a03c4c0832cd39a64ab8356a9a32dff8cdcfc4efa925bfc743d460b42707d3f7,225,348659,3241,14.4
136,cd6fa3d4f630f4a4d817a386b22e01875329d946a3366337f40231e33ea674bb,518,2687842,cd6fa3d4f630f4a4d817a386b22e01875329d946a3366337f40231e33ea674bb,518,2681880,5962,11.51
137,f0569b1ced26af655656d5415b4c56a2686e024e7090f1b82891828e78da71dc,223,239400,f0569b1ced26af655656d5415b4c56a2686e024e7090f1b82891828e78da71dc,223,235900,3500,15.7
138,0d9aa9ce68bbe577d5353a302b4c1e8cdaf07d299d6c1a2aa48f7bb701c24f35,222,675362,0d9aa9ce68bbe577d5353a302b4c1e8cdaf07d299d6c1a2aa48f7bb701c24f35,222,674383,979,4.41
139,b478318f56d0754a17fbcab5e4dfe20ec499ec770d0cdeb3779f03b5703c8de5,222,1661259,b478318f56d0754a17fbcab5e4dfe20ec499ec770d0cdeb3779f03b5703c8de5,222,1659261,1998,9
140,c85b8e835de627371a123642cae0bd31eeaed501470461de02dfd12f21d706df,192,257740,c85b8e835de627371a123642cae0bd31eeaed501470461de02dfd12f21d706df,192,255562,2178,11.34
141,0ec00534b33c8df338cb62729b34b4c8cc01564f8d8f9b3af772376f51cd27b0,372,62849,0ec00534b33c8df338cb62729b34b4c8cc01564f8d8f9b3af772376f51cd27b0,372,57389,5460,14.68
142,35bf58cef7dca790e29792072e1cf077e9d8eb6f058daf60ce6ae145a529b909,370,1082617,35bf58cef7dca790e29792072e1cf077e9d8eb6f058daf60ce6ae145a529b909,370,1077246,5371,14.52
143,46089cb0fbdc639ec33d691844ce1a76aa83c32b7e7439586225d658332c6539,351,369200681,46089cb0fbdc639ec33d691844ce1a76aa83c32b7e7439586225d658332c6539,351,369066528,134153,382.2
144,720caf6700657ea63fa06586dd53842db3beff7d9a51e0a74efb883e179a3b89,222,2387809,720caf6700657ea63fa06586dd53842db3beff7d9a51e0a74efb883e179a3b89,222,2384171,3638,16.39
145,7714c686cf02481350a506271913e19514cd63a306788fd42a731413f171b62f,222,1943089,7714c686cf02481350a506271913e19514cd63a306788fd42a731413f171b62f,222,1937629,5460,24.59
146,aabbe9595d71786b4f66cf7c6d55463717198d9a23429386b19610653489c256,345,200000,aabbe9595d71786b4f66cf7c6d55463717198d9a23429386b19610653489c256,345,199276,724,2.1
147,026f3e8d23e3d505791fea0619ba3e7c989939f02e2bd28b4a1cb357fa89ec2a,340,156431,026f3e8d23e3d505791fea0619ba3e7c989939f02e2bd28b4a1cb357fa89ec2a,340,151371,5060,14.88
148,323e7727da43c903bd18d2c8c323350a8a653ec39d57400373e055846f018d8a,226,3626993,323e7727da43c903bd18d2c8c323350a8a653ec39d57400373e055846f018d8a,226,3622910,4083,18.07
149,3a83766a1dd17576971426bd31e726fdb9ca6096e25e4513898dec9cc865db45,249,17607,3a83766a1dd17576971426bd31e726fdb9ca6096e25e4513898dec9cc865db45,249,16118,1489,5.98
150,0ea2b232498f3a16c9bc2a5b0c65706d34ba67403e20d8a5efd19f3f4bc8451b,506,97096,0ea2b232498f3a16c9bc2a5b0c65706d34ba67403e20d8a5efd19f3f4bc8451b,506,87918,9178,18.14
151,129d4a2552757cc23fde785a99aacaffaef828cecedaf9870a0ae09a0fd56dd7,154,2500,129d4a2552757cc23fde785a99aacaffaef828cecedaf9870a0ae09a0fd56dd7,154,1884,616,4
152,2d13eafb8cd72224b78c7a411af7f0e741c580aaabfa37f626ade0790a41c5f9,191,358241035,2d13eafb8cd72224b78c7a411af7f0e741c580aaabfa37f626ade0790a41c5f9,191,358230685,10350,54.19
153,8b9d1410d62150bf8d2d7f4f26dd85ef010d37611fbcd9a0c88a07318a1bbfe6,506,100114,8b9d1410d62150bf8d2d7f4f26dd85ef010d37611fbcd9a0c88a07318a1bbfe6,506,90936,9178,18.14
154,c61063a7e877b7a4483c197386b3a32cd82448cf0413fc0739d8ad01b71527e5,225,857521,c61063a7e877b7a4483c197386b3a32cd82448cf0413fc0739d8ad01b71527e5,225,854194,3327,14.79
155,1ab239a4cedfd9614e921985d5ce707fc95fae4e7b68a6b62d69c9acffd9866b,188,477725,1ab239a4cedfd9614e921985d5ce707fc95fae4e7b68a6b62d69c9acffd9866b,188,472459,5266,28.01
156,1df6bfdcf79ec04f927314257147b7867d628e0891f19f7e120cfda9eab459f4,317,10900,1df6bfdcf79ec04f927314257147b7867d628e0891f19f7e120cfda9eab459f4,317,10000,900,2.84
157,54d357fe10405b012e2eb2ae159e4b5ff17eef092fc71b1ad00c39316d273999,194,2945159,54d357fe10405b012e2eb2ae159e4b5ff17eef092fc71b1ad00c39316d273999,194,2939933,5226,26.94
158,5a6b97cc719063a7b7c52f7021dfafa53d9d726a75d41546bd0e425eb5c077f4,373,39535520,5a6b97cc719063a7b7c52f7021dfafa53d9d726a75d41546bd0e425eb5c077f4,373,39529415,6105,16.37
159,a10ef61b75ac914f5bbabab5bb84d174c3e49c1ac5bee075538a20ca40290ca1,200,1803000,a10ef61b75ac914f5bbabab5bb84d174c3e49c1ac5bee075538a20ca40290ca1,200,1797734,5266,26.33
160,b7b2e6e721b9ee37cf1af5d078a49821e31893c9d4403009f1cd38e69b40ab46,234,1617702,b7b2e6e721b9ee37cf1af5d078a49821e31893c9d4403009f1cd38e69b40ab46,234,1615939,1763,7.53
161,bbe7291b48d83fddf16107c44d5a6f48c57d0c8938203552a5c318476b62ddee,223,2847784,bbe7291b48d83fddf16107c44d5a6f48c57d0c8938203552a5c318476b62ddee,223,2846470,1314,5.89
162,e9cc7a20ebc53e5c141c8b027eee7e26fb41cc0e485f0ae8391d62d4e00e512e,534,8297190,e9cc7a20ebc53e5c141c8b027eee7e26fb41cc0e485f0ae8391d62d4e00e512e,534,8269590,27600,51.69
163,0fe310d44966d00977b0388fddbcf3b8b49a43c6244ec9ba4472233dd2fab470,419,951536,0fe310d44966d00977b0388fddbcf3b8b49a43c6244ec9ba4472233dd2fab470,419,944770,6766,16.15
164,1f2c85519232c05e09259cd1696e10065e93de2b83da89fd30116555e6c6c85a,1473,306003427,1f2c85519232c05e09259cd1696e10065e93de2b83da89fd30116555e6c6c85a,1473,305994600,8827,5.99
165,94acf995968f5d696016a26fbde6917fb2749a0919518633e3bae017239a6ff4,223,3106817,94acf995968f5d696016a26fbde6917fb2749a0919518633e3bae017239a6ff4,223,3103125,3692,16.56
166,a4e245660ffbeabb547f986328d2f8b5837466cecb40cf6bc6885a9f8debff35,713,226956,a4e245660ffbeabb547f986328d2f8b5837466cecb40cf6bc6885a9f8debff35,713,215997,10959,15.37
167,ad4503647fe5c97ad88e23fd6df308e300b3db00c1d0639320e44abccb47752e,225,621778880,ad4503647fe5c97ad88e23fd6df308e300b3db00c1d0639320e44abccb47752e,225,621756389,22491,99.96
168,b3710b5b22252a2c17b99d32494ffd03867a99cf245f3cce263ce160b3cbbe1e,225,130250000,b3710b5b22252a2c17b99d32494ffd03867a99cf245f3cce263ce160b3cbbe1e,225,130248900,1100,4.89
169,4846ebc051f9d780695456a1cbd2bb1bdc481f54d5818412d151a0bdca6072e9,225,17178933,4846ebc051f9d780695456a1cbd2bb1bdc481f54d5818412d151a0bdca6072e9,225,17174433,4500,20
170,dd72ccfdbd32f6dd2a3d17a8a93aaf1b3ce4c526e0e22e705da9ff304e38ce22,222,1036670,dd72ccfdbd32f6dd2a3d17a8a93aaf1b3ce4c526e0e22e705da9ff304e38ce22,222,1031213,5457,24.58
171,23bac7aba26f742991fdb1f5fb8494b2269fac598a285bffe66dcb2ebe93b9c9,371,1372765,23bac7aba26f742991fdb1f5fb8494b2269fac598a285bffe66dcb2ebe93b9c9,371,1369034,3731,10.06
172,43e73ccd83b28aa1619d418fcb0468aa77f19ede0c9db7c3a4b3d26cbafd749d,191,487856050,43e73ccd83b28aa1619d418fcb0468aa77f19ede0c9db7c3a4b3d26cbafd749d,191,487853190,2860,14.97
173,5593ac45e03d339a4a45e39186da00f01fbe0c6548a964b07cbd64d788c69f79,776,4230393,5593ac45e03d339a4a45e39186da00f01fbe0c6548a964b07cbd64d788c69f79,776,4225650,4743,6.11
174,a3b287f24bbbf106d4891bd92fb4d2bd2d7f4f2914002baf47ca3cb622a6336b,224,637387,a3b287f24bbbf106d4891bd92fb4d2bd2d7f4f2914002baf47ca3cb622a6336b,224,634852,2535,11.32
175,b52ba64bc0fe63c117c836f260c97313f90ca9eb3a47d8bc44a0a22aa2b726f5,192,743970,b52ba64bc0fe63c117c836f260c97313f90ca9eb3a47d8bc44a0a22aa2b726f5,192,741792,2178,11.34
176,24105f711d982c61aad371618239e119fc4c4ee8fa10b895a6a5009ebbeb5302,635,3699022,24105f711d982c61aad371618239e119fc4c4ee8fa10b895a6a5009ebbeb5302,635,3691372,7650,12.05
177,4d95d4e63f0a06fb6002ec45c866af60dc3a5b90788776870f9fde11a83c812d,234,1144011,4d95d4e63f0a06fb6002ec45c866af60dc3a5b90788776870f9fde11a83c812d,234,1141701,2310,9.87
178,60b6710f12b402a85a0b91344a8163ded8f47d8ed75d6d6b4c596b84d44c9d7b,868,300979,60b6710f12b402a85a0b91344a8163ded8f47d8ed75d6d6b4c596b84d44c9d7b,868,284345,16634,19.16
179,c8887afda697d49c49d072f2b8a13b418f0b4c1a9ccfe978e0378112ec686126,312,25408,c8887afda697d49c49d072f2b8a13b418f0b4c1a9ccfe978e0378112ec686126,312,24136,1272,4.08
180,de61f06b1bffeaadae5cba62128e965fad1c004746f61b0856cd4954c51bb22f,195,853992,de61f06b1bffeaadae5cba62128e965fad1c004746f61b0856cd4954c51bb22f,195,851173,2819,14.46
181,ed9390b1c0e1f2cd3d119cb9cc3e9dd4e97f2ef098372cab4e6f66e129e6975e,234,1160105,ed9390b1c0e1f2cd3d119cb9cc3e9dd4e97f2ef098372cab4e6f66e129e6975e,234,1158342,1763,7.53
182,00a87e2043a0b0bb53bf1662d5d64da6b72dfcd478089abc67e97682622113d4,524,1084795,00a87e2043a0b0bb53bf1662d5d64da6b72dfcd478089abc67e97682622113d4,524,1076725,8070,15.4
183,0ae5b4577f61f3eb1f4b80c67b7b775b16018816354253482dde8095fe81b5ff,223,1473000,0ae5b4577f61f3eb1f4b80c67b7b775b16018816354253482dde8095fe81b5ff,223,1469359,3641,16.33
184,7a0e60203625f25bf4f22cd646095046c4c3bd661c1289e3811a4d06fdedbd18,317,1606,7a0e60203625f25bf4f22cd646095046c4c3bd661c1289e3811a4d06fdedbd18,317,546,1060,3.34
185,94c0fc1d4e716416fb377c724f85e2cf9f58c7949fcbb267720629b6918e2973,605,31373488,94c0fc1d4e716416fb377c724f85e2cf9f58c7949fcbb267720629b6918e2973,605,31361866,11622,19.21
186,9e9135fe1fbdb92bb859295629f58fee7b5ead744ad3ecd732d941439dbf235a,339,167700,9e9135fe1fbdb92bb859295629f58fee7b5ead744ad3ecd732d941439dbf235a,339,163375,4325,12.76
187,b2b0ae91c41d76614f6f2b38bb50018e653320994f28d53d617f2f5ef9c1fb09,343,23713192,b2b0ae91c41d76614f6f2b38bb50018e653320994f28d53d617f2f5ef9c1fb09,343,23708486,4706,13.72
188,f238c23b746b1e4cedab156259c2389dee7b2870ca887ae3978c9acc909d12b4,235,4044386,f238c23b746b1e4cedab156259c2389dee7b2870ca887ae3978c9acc909d12b4,235,4040647,3739,15.91
189,fc9acf4867306abd93b9acdcf1f40ffcfa23a41886fb6849058a1c2749e2e52b,188,30667,fc9acf4867306abd93b9acdcf1f40ffcfa23a41886fb6849058a1c2749e2e52b,188,26000,4667,24.82
190,18588ef212d7149405593f249fb43ec85e557bdfb3ab777dbf8ea72cdc99c502,225,634026,18588ef212d7149405593f249fb43ec85e557bdfb3ab777dbf8ea72cdc99c502,225,630282,3744,16.64
191,63916e11eedf2c10c4b2cb6e9e8a007bbb01563fb9eccf8b8a47567143884bec,223,78258,63916e11eedf2c10c4b2cb6e9e8a007bbb01563fb9eccf8b8a47567143884bec,223,74592,3666,16.44
192,f4e3093817b44ba95007e25ec560ec69fc4e30c34b88f90d0e3206230df5900a,247,2679582,f4e3093817b44ba95007e25ec560ec69fc4e30c34b88f90d0e3206230df5900a,247,2677232,2350,9.51
193,fefb3096bcf63ad735acf5c72b63c670e2bb4aac8bebdc8d5e95d326ae39aa3c,222,1316542,fefb3096bcf63ad735acf5c72b63c670e2bb4aac8bebdc8d5e95d326ae39aa3c,222,1315534,1008,4.54
194,ff7a69f26a65d04bae68641ec00112c462e8637dd1d03943220a0828863f5255,192,153397,ff7a69f26a65d04bae68641ec00112c462e8637dd1d03943220a0828863f5255,192,150511,2886,15.03
195,3747f875c6ad003e0e7649ba40fa18e12552723568ef7335d64730a16b0a619b,222,20699014,3747f875c6ad003e0e7649ba40fa18e12552723568ef7335d64730a16b0a619b,222,20696497,2517,11.34
196,6424b7b91529f44b2142c1e6de1c103a6214a3086fa4ec6b14a49b9f3fb3d0fb,191,53011076,6424b7b91529f44b2142c1e6de1c103a6214a3086fa4ec6b14a49b9f3fb3d0fb,191,53008216,2860,14.97
197,d61d3526f8b96eae3a05b90a2cc679ce4b78e9b3608aa4701d9a11c208d73e6b,439,6325629,d61d3526f8b96eae3a05b90a2cc679ce4b78e9b3608aa4701d9a11c208d73e6b,439,6320569,5060,11.53
198,eb858cec8d445eac8133d5aee441bbfb4a27f4646902285769424eb171afe2d4,412,87403399,eb858cec8d445eac8133d5aee441bbfb4a27f4646902285769424eb171afe2d4,412,87396990,6409,15.56
199,02d0d48e87d93bd2c7c9705f48a27e680a6a87441c9fddb06cc61eb21cf89ca3,192,930805,02d0d48e87d93bd2c7c9705f48a27e680a6a87441c9fddb06cc61eb21cf89ca3,192,927919,2886,15.03
200,2620db8dad6a99942c62e66f9e7c8859c53e5e69ca8c3adf1eadf3b7dc3ce4e2,519,3592848,2620db8dad6a99942c62e66f9e7c8859c53e5e69ca8c3adf1eadf3b7dc3ce4e2,519,3587885,4963,9.56
201,326f50c7b332c3bf07fd3946bb152e4f7a51c9b23635afa3f500f4db9c492d52,224,30404590,326f50c7b332c3bf07fd3946bb152e4f7a51c9b23635afa3f500f4db9c492d52,224,30400924,3666,16.37
202,4b204df1241e51f32de2378f3af2fc274ecd20391436a1c22f411b893fd5cf05,223,154712,4b204df1241e51f32de2378f3af2fc274ecd20391436a1c22f411b893fd5cf05,223,150659,4053,18.17
203,4cccf09c3f4320ffac8b36fc180d90739ba4b7fb4c89b12a90f61a5e430b616d,390,352455,4cccf09c3f4320ffac8b36fc180d90739ba4b7fb4c89b12a90f61a5e430b616d,390,349386,3069,7.87
204,d45823f9c3444cda4bbee44593c2ecdf8229793b4d8a6c482467206c49163219,372,513871,d45823f9c3444cda4bbee44593c2ecdf8229793b4d8a6c482467206c49163219,372,512418,1453,3.91
205,ea2b84c1618a5c14a5b8e9804e9ec43da83a87f558a6fd1bf66ceb1ceadefcbe,195,163797,ea2b84c1618a5c14a5b8e9804e9ec43da83a87f558a6fd1bf66ceb1ceadefcbe,195,160859,2938,15.07
206,a91eeab6361fe5bb4dfe165a2ac63ceeaaf45fae5b24734fca416593e799063b,375,6586170,a91eeab6361fe5bb4dfe165a2ac63ceeaaf45fae5b24734fca416593e799063b,375,6584695,1475,3.93
207,eab825f6c7d80ccb03666ad22e4a955db82b09cf1d2e665f21385f291967dfa6,222,3339369,eab825f6c7d80ccb03666ad22e4a955db82b09cf1d2e665f21385f291967dfa6,222,3334849,4520,20.36
208,12169bbb56b8a123577b0ee3e438c2880b0e43ea30373a648ee863eca3e4cf08,569,614217,12169bbb56b8a123577b0ee3e438c2880b0e43ea30373a648ee863eca3e4cf08,569,604604,9613,16.89
209,59e4af5023915b225991e05475822fce35208db7d248ea15f557662a4b437d59,154,5000,59e4af5023915b225991e05475822fce35208db7d248ea15f557662a4b437d59,154,3768,1232,8
210,ada9973b724015a9abf9766411b712535a7131c168ae5f841d8fe012b7ae5b9d,190,101000,ada9973b724015a9abf9766411b712535a7131c168ae5f841d8fe012b7ae5b9d,190,95138,5862,30.85
211,b020f071ba0c1d0bd15ceaaded9ffe5b0698d79535de4ae0456e51652c3dd2cd,222,462308813,b020f071ba0c1d0bd15ceaaded9ffe5b0698d79535de4ae0456e51652c3dd2cd,222,462303080,5733,25.82
212,b7cf64be9669779519220e3e9abe9e4a1e2abe5176ef946783cba5aed49f2f3c,226,1711879,b7cf64be9669779519220e3e9abe9e4a1e2abe5176ef946783cba5aed49f2f3c,226,1710703,1176,5.2
213,db1dec5bde4e099b72599472cfd922b4c8eb7087da282d6fb0443ecb35c6cbad,317,1606,db1dec5bde4e099b72599472cfd922b4c8eb7087da282d6fb0443ecb35c6cbad,317,546,1060,3.34
214,677f09d7543985535d1c99e19d852bbf195af5275ecbf8272c8996ea1f68cf42,191,288813,677f09d7543985535d1c99e19d852bbf195af5275ecbf8272c8996ea1f68cf42,191,288142,671,3.51
215,90ae92056de495dcd1c79b9df6f8f2a0d5c58d28207777d83903b3c2480e74ef,372,4593926,90ae92056de495dcd1c79b9df6f8f2a0d5c58d28207777d83903b3c2480e74ef,372,4592926,1000,2.69
216,c8ca65e64b5b4bdbb26099909f3fe6533faa3582837b856cd0bf3891fb976cea,225,117884645,c8ca65e64b5b4bdbb26099909f3fe6533faa3582837b856cd0bf3891fb976cea,225,117881318,3327,14.79
217,ce3726a9b8b14589bacd82cec310e18417099a16662e8ac58f7d7eed436b2948,225,82377,ce3726a9b8b14589bacd82cec310e18417099a16662e8ac58f7d7eed436b2948,225,76547,5830,25.91
218,31e75b2fe5b6cc30eb100ee129378d6419d7dc06b3d9f3c8837633796d525b30,224,46607,31e75b2fe5b6cc30eb100ee129378d6419d7dc06b3d9f3c8837633796d525b30,224,43475,3132,13.98
219,3f0439f0cadd3fb2a132b68290d026e955eb4fe14e128cb70ee4d02b46770619,224,423283,3f0439f0cadd3fb2a132b68290d026e955eb4fe14e128cb70ee4d02b46770619,224,418443,4840,21.61
220,5cdaae862f26d16ea58fe892df932da209e7dfc91065a28b77f837db957e7eb5,1103,201417472,5cdaae862f26d16ea58fe892df932da209e7dfc91065a28b77f837db957e7eb5,1103,201385790,31682,28.72
221,8e018b20a27111a60b408679dcc2479d99d871c13c735abf7e67ada89ebd58c0,223,4671926,8e018b20a27111a60b408679dcc2479d99d871c13c735abf7e67ada89ebd58c0,223,4668247,3679,16.5
222,a8c80f856372b330362184728270227cd118f4d19a9339aea1e5cbfc38fe7201,371,715330,a8c80f856372b330362184728270227cd118f4d19a9339aea1e5cbfc38fe7201,371,709312,6018,16.22
223,0af2c6a2fd976794d547150219515cb24df770d51370cef9738a4591bf4fc08d,523,5246613,0af2c6a2fd976794d547150219515cb24df770d51370cef9738a4591bf4fc08d,523,5244663,1950,3.73
224,2986f22db923ee491e97648e8dc83f2f28515a1a88f38d5e81676ebc06d7cbb1,226,1346399,2986f22db923ee491e97648e8dc83f2f28515a1a88f38d5e81676ebc06d7cbb1,226,1342655,3744,16.57
225,cb3a3de73f5c0f2ed5fd11f008fe6247949d11493ae10bc80ffbdcab3f9c4717,223,2085368355,cb3a3de73f5c0f2ed5fd11f008fe6247949d11493ae10bc80ffbdcab3f9c4717,223,2085364714,3641,16.33
226,fec32d428884136ff66e855384a3098977b45111c35b125e7e4bd4b3e49c57df,224,97919,fec32d428884136ff66e855384a3098977b45111c35b125e7e4bd4b3e49c57df,224,94227,3692,16.48
227,3b154b5820fe3c18744cec3367a46d8f2608f8615f8e75ec6385c3d605566062,234,41450448,3b154b5820fe3c18744cec3367a46d8f2608f8615f8e75ec6385c3d605566062,234,41449224,1224,5.23
228,750773f2655fd087fbc61d5bb0e98d2d1ee9ae5a3d1591ff5e1541f1e2baa7d5,398,8927,750773f2655fd087fbc61d5bb0e98d2d1ee9ae5a3d1591ff5e1541f1e2baa7d5,398,7000,1927,4.84
229,ab74c3f43e6265748549e83b0ee1ac1fa5a3414ce9fec2fffa13daddd8eb5128,223,1451828,ab74c3f43e6265748549e83b0ee1ac1fa5a3414ce9fec2fffa13daddd8eb5128,223,1448162,3666,16.44
230,ba280aacdae0e8c481873b1a0800ddf9f58e98727a20553a056800a066dc7978,223,557572,ba280aacdae0e8c481873b1a0800ddf9f58e98727a20553a056800a066dc7978,223,555186,2386,10.7
231,72516c3ff1c1a7ecd2f23e3f5197b1a39dff9a1687ba41fe4eebf8ec3c402dd8,523,193139,72516c3ff1c1a7ecd2f23e3f5197b1a39dff9a1687ba41fe4eebf8ec3c402dd8,523,185859,7280,13.92
232,88b5c1aa1ec6566667ee1764b448fdeedf1b31a90feb4b332ae4c32e2d4c6dd8,372,48943425,88b5c1aa1ec6566667ee1764b448fdeedf1b31a90feb4b332ae4c32e2d4c6dd8,372,48936145,7280,19.57
233,657352e4964cb300c36af3d9650126a5f6ad00cfd790082e57df866ddd0f139c,541,106213212,657352e4964cb300c36af3d9650126a5f6ad00cfd790082e57df866ddd0f139c,541,106203378,9834,18.18
234,65c1b3853d125281670d1ae06ab6df76ae16f4dbdc6f5e53da9e58bed81f1973,191,120000,65c1b3853d125281670d1ae06ab6df76ae16f4dbdc6f5e53da9e58bed81f1973,191,108780,11220,58.74
235,cfee1e2955ae7ade0b2532aaa91dd24ea18ab2327944e2ba074a51259c7e0d28,537,335472,cfee1e2955ae7ade0b2532aaa91dd24ea18ab2327944e2ba074a51259c7e0d28,537,325496,9976,18.58
236,644138d69b9331280eb5cd955818a18c082fbaec415788d63321ab2f2e2de1e9,247,77644,644138d69b9331280eb5cd955818a18c082fbaec415788d63321ab2f2e2de1e9,247,76801,843,3.41
237,a29ba1c66519ba64ba69529924d7d5d3a8920fd9ab319332596c43d931d60dc7,188,189062,a29ba1c66519ba64ba69529924d7d5d3a8920fd9ab319332596c43d931d60dc7,188,183195,5867,31.21
238,f3b0f257f081b4060d0743c76962913b4db62cee1a6b094a587128081a075797,195,60081,f3b0f257f081b4060d0743c76962913b4db62cee1a6b094a587128081a075797,195,57143,2938,15.07
239,8e9299cc5032d95e7773c90d9f0899162e5d551ff10441e4746c07370314690b,226,579212,8e9299cc5032d95e7773c90d9f0899162e5d551ff10441e4746c07370314690b,226,575468,3744,16.57
240,976ac3303ede8e582cb36a3c0789fde9115e94854fd7dce33d961209f24b1922,373,6415633,976ac3303ede8e582cb36a3c0789fde9115e94854fd7dce33d961209f24b1922,373,6414158,1475,3.95
241,20eaa2d3be9b6b85481b64df8865a738bbaf89a3e3dadc01356609affa4771d0,1415,1382596,20eaa2d3be9b6b85481b64df8865a738bbaf89a3e3dadc01356609affa4771d0,1415,1347901,34695,24.52
242,3c09103ce05527bb60ecfa27270b8ad658c867b85beac3d88c1931f8a76d3d62,319,47983196,3c09103ce05527bb60ecfa27270b8ad658c867b85beac3d88c1931f8a76d3d62,319,47976294,6902,21.64
243,d5aa2f3b6433aa2623dc0bdb6622309f4b1e9b38f906815e3061579671e75dd0,191,301424,d5aa2f3b6433aa2623dc0bdb6622309f4b1e9b38f906815e3061579671e75dd0,191,298564,2860,14.97
244,dd6745a7bd67b424ea44920f2897a0ff7b30b6898e2d31ca6f68951c065c4ee7,279,3513847,dd6745a7bd67b424ea44920f2897a0ff7b30b6898e2d31ca6f68951c065c4ee7,279,3505552,8295,29.73
245,e7e85adff5b813eccbabd75a616663a9f8bbc5841e626e91b1c320d11d016b80,225,6322400,e7e85adff5b813eccbabd75a616663a9f8bbc5841e626e91b1c320d11d016b80,225,6319520,2880,12.8
246,26dc63873c0e679d74268ba789c9f8a9eada612661b07a260cba2fe8dbb31d1b,223,2898498,26dc63873c0e679d74268ba789c9f8a9eada612661b07a260cba2fe8dbb31d1b,223,2894806,3692,16.56
247,7369ccd2b9d6f4567cac0e17b35e7e5d660a6ae1b284f21a1b8db03ac2886598,195,161939,7369ccd2b9d6f4567cac0e17b35e7e5d660a6ae1b284f21a1b8db03ac2886598,195,159001,2938,15.07
248,c45f7db32ca4dbe7c8340a322bf394f4a75d9e560c2fa0cb06014cc8d4b170bd,194,483805,c45f7db32ca4dbe7c8340a322bf394f4a75d9e560c2fa0cb06014cc8d4b170bd,194,481927,1878,9.68
249,8fc3ee8620f52cc1ae1c7964e30e45681e5b014dbd067a8abd4510c85ba342b0,462,487189,8fc3ee8620f52cc1ae1c7964e30e45681e5b014dbd067a8abd4510c85ba342b0,462,479674,7515,16.27
250,ba2258cbe37d5c9ce6ca24fbd6d8fe1db403d868dbdbb5b61dda6066b72acefb,194,895711,ba2258cbe37d5c9ce6ca24fbd6d8fe1db403d868dbdbb5b61dda6066b72acefb,194,892954,2757,14.21
251,10e1e07e9814b4a37200f0d60b7c02fd58384e08b5e80b9fcf076916ef81cf97,380,2639669,10e1e07e9814b4a37200f0d60b7c02fd58384e08b5e80b9fcf076916ef81cf97,380,2634360,5309,13.97
252,16d08d2f867f963a72141da66117ff6c3e7ce6b27e02a5d0a03f51a3fb9d46d8,225,336052,16d08d2f867f963a72141da66117ff6c3e7ce6b27e02a5d0a03f51a3fb9d46d8,225,332308,3744,16.64
253,5968b27181bdb48d2e2b25d866314a5fc790d7ca048ae118687ca46a1ae3ebd0,351,1415817269,5968b27181bdb48d2e2b25d866314a5fc790d7ca048ae118687ca46a1ae3ebd0,351,1415807419,9850,28.06
254,65e70975aff2cd7b1f25ca8403bac2fe0ecf6affd47397ce8f914edeab45c402,225,171727102,65e70975aff2cd7b1f25ca8403bac2fe0ecf6affd47397ce8f914edeab45c402,225,171723384,3718,16.52
255,717125f8edbc2c63d485478ee6fb0885081419e77c7d375bb111679e3d882a28,223,3413469,717125f8edbc2c63d485478ee6fb0885081419e77c7d375bb111679e3d882a28,223,3412490,979,4.39
256,8fbfe3af15128310e8a9fdcb9c66fb9dcbdbd3f0e172e3cb2035e13a891e8267,493,533593,8fbfe3af15128310e8a9fdcb9c66fb9dcbdbd3f0e172e3cb2035e13a891e8267,493,531822,1771,3.59
257,ccb877c6f035eb8dcc9ad0bb01fe4ef25074508d5980f1a54785f3209fa91fb4,225,25292,ccb877c6f035eb8dcc9ad0bb01fe4ef25074508d5980f1a54785f3209fa91fb4,225,19416,5876,26.12
258,d5aff1b3010a32d08ab19adfd0b7f9e0ddf87f0a9ebe78e5dcc23943347aa2dc,226,13927147,d5aff1b3010a32d08ab19adfd0b7f9e0ddf87f0a9ebe78e5dcc23943347aa2dc,226,13925565,1582,7
259,0a10269ab7e2fa252106749cf9078dfb43dd9090d23d559f3a69a22c28b53952,192,202986,0a10269ab7e2fa252106749cf9078dfb43dd9090d23d559f3a69a22c28b53952,192,200126,2860,14.9
260,1a16a6a25a2545aded61da3192b419dd5692b76c2ba9f08d695e579997f38551,193,168567,1a16a6a25a2545aded61da3192b419dd5692b76c2ba9f08d695e579997f38551,193,165681,2886,14.95
261,186727585b3afcce75acfb12c3bc48acd118222e517acb02e08edcf5ea22fecc,192,1183258,186727585b3afcce75acfb12c3bc48acd118222e517acb02e08edcf5ea22fecc,192,1182488,770,4.01
262,5c9745d4a28b51f9a8afad11a22e8d772f227551f8bfc79d7fb8e6c2bde79ead,223,2277630,5c9745d4a28b51f9a8afad11a22e8d772f227551f8bfc79d7fb8e6c2bde79ead,223,2275095,2535,11.37
263,78f0b75f36cdd41effcc07d047871bfd6d767c591f865ad0ad7db216354f64db,370,256942,78f0b75f36cdd41effcc07d047871bfd6d767c591f865ad0ad7db216354f64db,370,247365,9577,25.88
264,4c7f059ecf3041edad1a44468a4ba33dba98bb205298cba90ffe6e7e7c2c753a,223,591088,4c7f059ecf3041edad1a44468a4ba33dba98bb205298cba90ffe6e7e7c2c753a,223,587513,3575,16.03
265,5de1e5c5647d112e02bdee7dd9b448b8e34d6f881f9bda2a1d7025fa6bc45f72,226,716300,5de1e5c5647d112e02bdee7dd9b448b8e34d6f881f9bda2a1d7025fa6bc45f72,226,714152,2148,9.5
266,bc95700559e00300376d2393d2027c7ba698216ba9614e03f16877adf7c9f3c3,373,155290,bc95700559e00300376d2393d2027c7ba698216ba9614e03f16877adf7c9f3c3,373,153815,1475,3.95
267,bd944644362e51f012b1019416fab21a752f45007188bda248219b294dbba6c9,346,433000,bd944644362e51f012b1019416fab21a752f45007188bda248219b294dbba6c9,346,430591,2409,6.96
268,c74d259a025e1f77766d8a068dc6b5da739973f538409cb6b1177c901508d321,222,8699514,c74d259a025e1f77766d8a068dc6b5da739973f538409cb6b1177c901508d321,222,8695873,3641,16.4
269,1d3cc6c2485057f46036cacb324b78dca683bfb753cb02d814697b2d0b17ab54,1410,1563874,1d3cc6c2485057f46036cacb324b78dca683bfb753cb02d814697b2d0b17ab54,1410,1560399,3475,2.46
270,6d69f04b6d92151c72b5b5027923e90935102aed57bdab226f99f048bf4edd2e,190,129279,6d69f04b6d92151c72b5b5027923e90935102aed57bdab226f99f048bf4edd2e,190,123256,6023,31.7
271,e8f51312b4141c1e7763f626a02bd89412bcdb8bb94d0e45346fe95a4b929c55,482,267027,e8f51312b4141c1e7763f626a02bd89412bcdb8bb94d0e45346fe95a4b929c55,482,264103,2924,6.07
272,08dcd709d976e389eb0977efb0cd30ce44693c3ae882cd0220890730caed1a3e,583,42173052,08dcd709d976e389eb0977efb0cd30ce44693c3ae882cd0220890730caed1a3e,583,42161004,12048,20.67
273,322fb46733cc1b09c0a843c84c4cd1c2b8c6b41de7214162ac655ef75e4b3d8f,339,9056,322fb46733cc1b09c0a843c84c4cd1c2b8c6b41de7214162ac655ef75e4b3d8f,339,5000,4056,11.96
274,43493edff1728afddc88aba2ac3bf0b99900ca1f164fed2aba62a38b7245b874,533,7978590,43493edff1728afddc88aba2ac3bf0b99900ca1f164fed2aba62a38b7245b874,533,7950990,27600,51.78
275,7dc2a21cf3c4e0403680b59838e02c28183c94df8c033ebc91638d77bc35448f,380,18333131,7dc2a21cf3c4e0403680b59838e02c28183c94df8c033ebc91638d77bc35448f,380,18322459,10672,28.08
276,0e63ccad7a092afe01c26e3bc6bd664342ef2765757fd7f2e28010746bf1220f,8725,318320489,0e63ccad7a092afe01c26e3bc6bd664342ef2765757fd7f2e28010746bf1220f,8725,318206676,113813,13.04
277,377256ba812be0019ffe8cc224cc763c458bfbc55394f37e1c1a9b4ab84df6b4,224,781764,377256ba812be0019ffe8cc224cc763c458bfbc55394f37e1c1a9b4ab84df6b4,224,778072,3692,16.48
278,5b2b7d3224024e71b2d88b2003ec8ebdb6bde50c254a177a78cd69305d82738a,447,30987659,5b2b7d3224024e71b2d88b2003ec8ebdb6bde50c254a177a78cd69305d82738a,447,30982472,5187,11.6
279,65dec6f90f2dc09b956817e022009975e71acecfd70731c217e7ebd14acd93bb,375,605995,65dec6f90f2dc09b956817e022009975e71acecfd70731c217e7ebd14acd93bb,375,600483,5512,14.7
280,6b200041964754f6a303d9173ab08ce03bbd476b26e17475c90ac88a81b828b2,957,1109761,6b200041964754f6a303d9173ab08ce03bbd476b26e17475c90ac88a81b828b2,957,1096201,13560,14.17
281,e3d845ee4a3e25ac71b46e894bddbff774621867130b43c328aaeb2f8ce8173e,223,236594,e3d845ee4a3e25ac71b46e894bddbff774621867130b43c328aaeb2f8ce8173e,223,232902,3692,16.56
282,19b143565ac3359cd98dfcfe2e7e1757fda5f9f9ae04f6cf0747ad79db48d7a1,222,24999000,19b143565ac3359cd98dfcfe2e7e1757fda5f9f9ae04f6cf0747ad79db48d7a1,222,24995193,3807,17.15
283,2f927a7b17aca9ad736a18fa86e53f8bf91955d2894e52c5bb47d4d9e1d720f3,248,147444,2f927a7b17aca9ad736a18fa86e53f8bf91955d2894e52c5bb47d4d9e1d720f3,248,142327,5117,20.63
284,400ad9ce1975801a05e505f367103d8c42baad35d900c2e3cfc1a89c765dca53,188,35262,400ad9ce1975801a05e505f367103d8c42baad35d900c2e3cfc1a89c765dca53,188,28762,6500,34.57
285,af3b7daf45eb9c27f118fe2934443140f0b0dd8b4dc348fae7ba9c258d248bad,154,5000,af3b7daf45eb9c27f118fe2934443140f0b0dd8b4dc348fae7ba9c258d248bad,154,4538,462,3
286,f9323588985094c00e9b250cf2419140feddee61fb6c8fe6f8bd1eda56917106,247,32877,f9323588985094c00e9b250cf2419140feddee61fb6c8fe6f8bd1eda56917106,247,32034,843,3.41
287,584a3dddae02635487544c394a24a3f355d121ef074af9814ed5e1cf82f1b0dd,226,344814,584a3dddae02635487544c394a24a3f355d121ef074af9814ed5e1cf82f1b0dd,226,341573,3241,14.34
288,5c034838bfeaa2e23f1d5606bb39ebd851d1ea98776fabc138e706bc9b141f78,222,2692244,5c034838bfeaa2e23f1d5606bb39ebd851d1ea98776fabc138e706bc9b141f78,222,2688493,3751,16.9
289,7a91cd144ad62d7e1571b1c985cd393aa1388ef8186e55bdcae3ed39f261064d,192,11726,7a91cd144ad62d7e1571b1c985cd393aa1388ef8186e55bdcae3ed39f261064d,192,8866,2860,14.9
290,b4ec5f284aead69c7c9e49eeaaf37b0a4709b0f6dcec3206d79fa142fe0dfc17,214,163706,b4ec5f284aead69c7c9e49eeaaf37b0a4709b0f6dcec3206d79fa142fe0dfc17,214,158187,5519,25.79
291,bffac20a115fa0ca2604e74ad0c9ed654dc2c8a7bd57d4a0fd95a18c5db20853,370,1598611,bffac20a115fa0ca2604e74ad0c9ed654dc2c8a7bd57d4a0fd95a18c5db20853,370,1591588,7023,18.98
292,e996e151f9e29724d5702ac69d0e490f997a3ed631e15c9e0d76b2517d0fa1e1,309,1600000,e996e151f9e29724d5702ac69d0e490f997a3ed631e15c9e0d76b2517d0fa1e1,309,1593417,6583,21.3
293,3b98870b2d8de6b2041ecb688b113efdb451731acce775e43862574b1af6980d,224,81831,3b98870b2d8de6b2041ecb688b113efdb451731acce775e43862574b1af6980d,224,79296,2535,11.32
294,3e3532153a5c64c90e1609c30fe93bad13ce1de3428bcad2f58fe0a07eaf33c8,223,319321,3e3532153a5c64c90e1609c30fe93bad13ce1de3428bcad2f58fe0a07eaf33c8,223,315629,3692,16.56
295,5dfeb63ed3dedd04001f9f56700c439ce61e86f5930e6c87e2327af22075bb17,234,1128838,5dfeb63ed3dedd04001f9f56700c439ce61e86f5930e6c87e2327af22075bb17,234,1126528,2310,9.87
296,8a84e87a11093730d7066d8179d9bbf62c1eac8e9695cfcfc44fde82607448c4,287,47983196,8a84e87a11093730d7066d8179d9bbf62c1eac8e9695cfcfc44fde82607448c4,287,47977428,5768,20.1
297,50b8526c5c8f7c01d0aea91447fd9f680d85da96eefb9e6ec8bafcdf8cbc102b,221,1121400,50b8526c5c8f7c01d0aea91447fd9f680d85da96eefb9e6ec8bafcdf8cbc102b,221,1117700,3700,16.74
298,90c4a979df8fdb9244d87780c0598ad56c0d002a3f9f62a6da1de9c994e2e6b5,234,1587257,90c4a979df8fdb9244d87780c0598ad56c0d002a3f9f62a6da1de9c994e2e6b5,234,1585494,1763,7.53
299,9ba667c1bacb2ee11ed0a478935dfd7f78c798a4f0d7b6b5fb5fe743f32ef61b,1357,9000000,9ba667c1bacb2ee11ed0a478935dfd7f78c798a4f0d7b6b5fb5fe743f32ef61b,1357,8872000,128000,94.33
300,c6842765634b0064ba9570fa52eba7d1e20d25ecb3faf0a90f172e4a1a0686b5,1663,26235454,c6842765634b0064ba9570fa52eba7d1e20d25ecb3faf0a90f172e4a1a0686b5,1663,26194605,40849,24.56
301,d0944a5c8469b70d6382b430f2127f1ec718e72bf1d6dd45a2978dddbfa92485,222,6223934,d0944a5c8469b70d6382b430f2127f1ec718e72bf1d6dd45a2978dddbfa92485,222,6222524,1410,6.35
302,a0fda12efdd695eeed2517d26e5f64075b8353912eb56199c1663711aec38cf5,226,4121781,a0fda12efdd695eeed2517d26e5f64075b8353912eb56199c1663711aec38cf5,226,4117998,3783,16.74
303,181b8acd8c679e193b0039488100e8be2c2d3ec0368640969883a084cec005b4,225,613120,181b8acd8c679e193b0039488100e8be2c2d3ec0368640969883a084cec005b4,225,612337,783,3.48
304,2662ee2cc21854010de36cf0505a4cb421907c030d812b9376595d7d40ef41b1,322,550153405,2662ee2cc21854010de36cf0505a4cb421907c030d812b9376595d7d40ef41b1,322,550116226,37179,115.46
305,49aaabd9c67472caad8d1ca5a5c7d1f685011ebfaad817304b278876f6536056,63938,106330,49aaabd9c67472caad8d1ca5a5c7d1f685011ebfaad817304b278876f6536056,63938,10000,96330,1.51
306,aded9d3a9fe618bab9a3727fbdeb02633281cbac90978943e07b7672a9456fa3,222,359420,aded9d3a9fe618bab9a3727fbdeb02633281cbac90978943e07b7672a9456fa3,222,354980,4440,20
307,521f8642699f82adff661d5327126a1ab799ce11f47b1a44e3900001a5f488e1,222,114471,521f8642699f82adff661d5327126a1ab799ce11f47b1a44e3900001a5f488e1,222,110805,3666,16.51
308,b1afcb9590777dc7f83c9f62867d56b5896d83d2331d997849d4237f17e3b8be,506,97315,b1afcb9590777dc7f83c9f62867d56b5896d83d2331d997849d4237f17e3b8be,506,88137,9178,18.14
309,baec995a8a80c15d10946e022309484fc95ad8d787fa5dd3286fd148e09bf1ae,226,1801829,baec995a8a80c15d10946e022309484fc95ad8d787fa5dd3286fd148e09bf1ae,226,1801537,292,1.29
310,eb87648352285199a9cfd679a2eab899a1812b11e9ed3106f7f5d43ce918b4a4,534,8084790,eb87648352285199a9cfd679a2eab899a1812b11e9ed3106f7f5d43ce918b4a4,534,8057190,27600,51.69
311,65416709f832f6a698efa6f03178126b42e42633c2f5731d7b1fd33fe7912bd8,279,10247754,65416709f832f6a698efa6f03178126b42e42633c2f5731d7b1fd33fe7912bd8,279,10239754,8000,28.67
312,ef3a30a2cfb088e3468cf625ac281708b7c4495f02f28c65d6c6dff2d3b7df47,372,346772,ef3a30a2cfb088e3468cf625ac281708b7c4495f02f28c65d6c6dff2d3b7df47,372,340725,6047,16.26
313,06ffa70ed314fe599d9565146b027692800fb4d9f3738df6375416d0b5015b15,235,381102,06ffa70ed314fe599d9565146b027692800fb4d9f3738df6375416d0b5015b15,235,373682,7420,31.57
314,6fd6c2a9c7359d757146f828bc5dcfec13fae7792e594c7b2cb05460c8125dcc,506,98105,6fd6c2a9c7359d757146f828bc5dcfec13fae7792e594c7b2cb05460c8125dcc,506,88927,9178,18.14
315,e3c3c7e0926526164b6666f4de4edfd11b4575af7871cdd73cae30da7332e40d,624,136874,e3c3c7e0926526164b6666f4de4edfd11b4575af7871cdd73cae30da7332e40d,624,127696,9178,14.71
316,e6793068a07e0589938e03a54df63ebfc32670b0afa1089c95d1df37a6b2ad16,518,7060650,e6793068a07e0589938e03a54df63ebfc32670b0afa1089c95d1df37a6b2ad16,518,7053891,6759,13.05
317,ff08895538d7a3d774be80027abbf40136f21aeebcfa6696467333937091eb65,191,2944000,ff08895538d7a3d774be80027abbf40136f21aeebcfa6696467333937091eb65,191,2941530,2470,12.93
318,0d31b0ade6299e07e4c2f33665bf8164dfaefd179285985c02cf790596696134,372,9515836,0d31b0ade6299e07e4c2f33665bf8164dfaefd179285985c02cf790596696134,372,9509818,6018,16.18
319,8810faf44b9abd4abafb19b401922c7b6121fce048ffb6c59a763bfe34fd3fc8,223,212234,8810faf44b9abd4abafb19b401922c7b6121fce048ffb6c59a763bfe34fd3fc8,223,211472,762,3.42
320,a781efd74f417e05b34985d2826043b8eb37ec4a722795dbfd4d7757bcfcdcb8,223,18948277,a781efd74f417e05b34985d2826043b8eb37ec4a722795dbfd4d7757bcfcdcb8,223,18945019,3258,14.61
321,b281e752a3ff1d1e0e7c430ea457d08e75743a33ec7dff627620d46d5cd353c8,343,993291,b281e752a3ff1d1e0e7c430ea457d08e75743a33ec7dff627620d46d5cd353c8,343,988585,4706,13.72
322,c1be0492801d19e392a1299f9147ab4e96f2fdbfc2f1355348e955f304e9fd64,771,3189068,c1be0492801d19e392a1299f9147ab4e96f2fdbfc2f1355348e955f304e9fd64,771,3178117,10951,14.2
323,1705279814fdd28019ef5b11700d3afe7ee9b3b2afa3b24793e6526a8cfe08fb,204,509000,1705279814fdd28019ef5b11700d3afe7ee9b3b2afa3b24793e6526a8cfe08fb,204,505828,3172,15.55
324,d3b4c44e4bf46d41dc48042305932fd33467b5eabb3c8a37ffcf7b0179ad07af,373,2552411,d3b4c44e4bf46d41dc48042305932fd33467b5eabb3c8a37ffcf7b0179ad07af,373,2548604,3807,10.21
325,d801e74aad6a353b2f1987b7bffe9fcc01556bc80399b7696b17002e2d48c196,247,641858,d801e74aad6a353b2f1987b7bffe9fcc01556bc80399b7696b17002e2d48c196,247,638901,2957,11.97
326,fec28f02186a131a41c23a2ad274ed58e6cae4ac6caeb41cab01f9af310007bd,277,310000,fec28f02186a131a41c23a2ad274ed58e6cae4ac6caeb41cab01f9af310007bd,277,309017,983,3.55
327,0ab8a67597b3654a5ed5342563516d2be8fd3d7e745c4d6b2f78bd7f2e6d2019,671,1201317,0ab8a67597b3654a5ed5342563516d2be8fd3d7e745c4d6b2f78bd7f2e6d2019,671,1199151,2166,3.23
328,83b210e7a4ebdb99a0bf92851871dbeb900c6f067e00c2997a0965b4333437fb,223,701994,83b210e7a4ebdb99a0bf92851871dbeb900c6f067e00c2997a0965b4333437fb,223,699100,2894,12.98
329,86e23f880fc4b1ee264be2e4a1471a41f0a53346042c737903ee89de10d294b4,533,8261790,86e23f880fc4b1ee264be2e4a1471a41f0a53346042c737903ee89de10d294b4,533,8234190,27600,51.78
330,8f8e07ccf5d6e517a755c61d403b3b5be8becce26a05e2ba6fe40879f4039abb,225,83000,8f8e07ccf5d6e517a755c61d403b3b5be8becce26a05e2ba6fe40879f4039abb,225,77048,5952,26.45
331,0fa9ed680862346f154a66f2f162e4ce5a8cd941cde0013413b33a1f3ec05c6b,192,805124,0fa9ed680862346f154a66f2f162e4ce5a8cd941cde0013413b33a1f3ec05c6b,192,804336,788,4.1
332,32b2b219b4d26f7747b8dc3a487cc818169fb7254401edb4425f253a8d4f0de8,585,30144561,32b2b219b4d26f7747b8dc3a487cc818169fb7254401edb4425f253a8d4f0de8,585,30064906,79655,136.16
333,91156014673ed5309365ab1d3a2e85e46583bb4846568df88dec31c316de531e,226,755443226,91156014673ed5309365ab1d3a2e85e46583bb4846568df88dec31c316de531e,226,755442327,899,3.98
334,edf7da3f4ef6a091e06d8ae2f2c65d72b005762fbcb8d4ca5d911aa768a17acd,222,3004216859,edf7da3f4ef6a091e06d8ae2f2c65d72b005762fbcb8d4ca5d911aa768a17acd,222,3004211402,5457,24.58
335,21c051331cb01b92e3f645d15d6aafdb2924bac9f0fe5d2ccd97716d82db7eeb,215,379301,21c051331cb01b92e3f645d15d6aafdb2924bac9f0fe5d2ccd97716d82db7eeb,215,358106,21195,98.58
336,481cfeea8655cc567ec87174bab1ec028ea6eddd1f5c1f079be5de8d05a19d4e,4135,17110606,481cfeea8655cc567ec87174bab1ec028ea6eddd1f5c1f079be5de8d05a19d4e,4135,17082596,28010,6.77
337,dfa7955590290d843b02b93309443fee09550e80962a5900311c7b6101c65238,374,451056,dfa7955590290d843b02b93309443fee09550e80962a5900311c7b6101c65238,374,449581,1475,3.94
338,4d932d29a39e06d2c0e01c71276c3895ab9fcae15018c5613760f955fd5506bd,10810,471343856,4d932d29a39e06d2c0e01c71276c3895ab9fcae15018c5613760f955fd5506bd,10810,471268825,75031,6.94
339,59ed7e24722940ee272d75d11698f5d4c6dbfa19544bd364ebd75dd1dd0d777e,192,57384,59ed7e24722940ee272d75d11698f5d4c6dbfa19544bd364ebd75dd1dd0d777e,192,54498,2886,15.03
340,c9daa181de31bb35a52fc6d1ea81eed4abb35abd92a4e475120ce0acb0b92702,222,991646,c9daa181de31bb35a52fc6d1ea81eed4abb35abd92a4e475120ce0acb0b92702,222,988536,3110,14.01
341,ea24c662bdc8d0f62940e6e561077a622692b67a2a48c6a77f4fcfc7031ce906,372,10068670,ea24c662bdc8d0f62940e6e561077a622692b67a2a48c6a77f4fcfc7031ce906,372,10067214,1456,3.91
342,2bcbbfb328368a189507c224bf174bd9a3bd03c7ff00950383dd38284233b22e,191,1762471,2bcbbfb328368a189507c224bf174bd9a3bd03c7ff00950383dd38284233b22e,191,1759787,2684,14.05
343,73b71195951e32191cd3c2bf23ae649e7b51bec8f9d3d521a3c938e64d8e429b,224,228012,73b71195951e32191cd3c2bf23ae649e7b51bec8f9d3d521a3c938e64d8e429b,224,224320,3692,16.48
344,04e4fb3e5d745b5648144e2dfd5a36fb026f7329eed5b2b46a0298e9ea6dc454,8543,5322160,04e4fb3e5d745b5648144e2dfd5a36fb026f7329eed5b2b46a0298e9ea6dc454,8543,5296420,25740,3.01
345,d17b6f2d75d9f662ad61c06a1e14268fcf87cf687d4c739d8182eba4bc197067,963,117689687,d17b6f2d75d9f662ad61c06a1e14268fcf87cf687d4c739d8182eba4bc197067,963,117669977,19710,20.47
346,399812255b03b3d7781bf94d9fca4f3ac215659a7ca7e884fd8e9769f336866e,223,208915,399812255b03b3d7781bf94d9fca4f3ac215659a7ca7e884fd8e9769f336866e,223,207936,979,4.39
347,44a56f60cd469a43da8312c9b5e285de9d077523a555c5b8261b275ae47217be,222,2079524,44a56f60cd469a43da8312c9b5e285de9d077523a555c5b8261b275ae47217be,222,2078545,979,4.41
348,4dacb5a4d26cb6e5ce9f1502e1fb0032471e140434b4fbce69f76b3a1d2f229c,966,18732371,4dacb5a4d26cb6e5ce9f1502e1fb0032471e140434b4fbce69f76b3a1d2f229c,966,18719839,12532,12.97
349,757d545689c26abeb025e8bc2b42b581a9506786d5c2f73ebfd4ae968813b209,62786,57301,757d545689c26abeb025e8bc2b42b581a9506786d5c2f73ebfd4ae968813b209,62786,10000,47301,0.75
350,8badd92824f72ffe184a67f5bf01b077474bba7cb93d07a059fad52278b2b204,370,323294,8badd92824f72ffe184a67f5bf01b077474bba7cb93d07a059fad52278b2b204,370,318905,4389,11.86
351,9ce8de3c4fa5afac8339ec6b2375f59a4a7a35825f8eb3bd6291d85ba2fa0fd5,235,4033647,9ce8de3c4fa5afac8339ec6b2375f59a4a7a35825f8eb3bd6291d85ba2fa0fd5,235,4029908,3739,15.91
352,5cf8e682c309fa37e31bcaa716e0131632adc853c4c8b9371fe677e30f2c04a1,381,4564450,5cf8e682c309fa37e31bcaa716e0131632adc853c4c8b9371fe677e30f2c04a1,381,4559326,5124,13.45
353,a05f91e21148f26077d57a0ac00faa8b4da80ab4a74ddfebba41743456651dc1,192,857137,a05f91e21148f26077d57a0ac00faa8b4da80ab4a74ddfebba41743456651dc1,192,854251,2886,15.03
354,be4f53f66a86c100418f22350ee3a8b30423dffa1008b8621ea7e79c46203a5c,222,7344939,be4f53f66a86c100418f22350ee3a8b30423dffa1008b8621ea7e79c46203a5c,222,7341299,3640,16.4
355,c5ebdccc7cc3c8b4d807011a7e377ce38063a60c85e644b1be66a13f181ccdd8,257,40000,c5ebdccc7cc3c8b4d807011a7e377ce38063a60c85e644b1be66a13f181ccdd8,257,33446,6554,25.5
356,d0d68fc4b77526c3f547b953705a9b4802fc750493b9c9e252c4359ec472f583,222,1448032,d0d68fc4b77526c3f547b953705a9b4802fc750493b9c9e252c4359ec472f583,222,1439400,8632,38.88
357,da9b207d39d6ca90e7ee2fe654f7dd43e8c77b396f0a5f1729f31e72ec03596c,1357,422958,da9b207d39d6ca90e7ee2fe654f7dd43e8c77b396f0a5f1729f31e72ec03596c,1357,405807,17151,12.64
358,e8265b463a9fdd0c78a9e6f74bffcee12adcc28df0f0476ba204c710bf579e98,318,972808386,e8265b463a9fdd0c78a9e6f74bffcee12adcc28df0f0476ba204c710bf579e98,318,972771666,36720,115.47
359,09a5c4c51e351848963b2f89aa118700862c14788cd59f7461352a548bd40756,222,13694019,09a5c4c51e351848963b2f89aa118700862c14788cd59f7461352a548bd40756,222,13690353,3666,16.51
360,0f4575e560b35ff98c28e7aa5f77988bf6aa97d41e9a9deaaa6dea1844095c04,251,1635240,0f4575e560b35ff98c28e7aa5f77988bf6aa97d41e9a9deaaa6dea1844095c04,251,1630667,4573,18.22
361,2b8c834eaef2cd2c0c99df4d11d6a20197115e69e470c19c604941e0b4444630,225,58164,2b8c834eaef2cd2c0c99df4d11d6a20197115e69e470c19c604941e0b4444630,225,56004,2160,9.6
362,f55325ac56e6e66d9f2f337db08673122c72265fbb239791a593d22f0efba313,192,352288,f55325ac56e6e66d9f2f337db08673122c72265fbb239791a593d22f0efba313,192,348700,3588,18.69
363,208ccd520b496567cc85273990b4d74b33196e6e56bd0b8d0d6593ba63d4f017,406,3932,208ccd520b496567cc85273990b4d74b33196e6e56bd0b8d0d6593ba63d4f017,406,2500,1432,3.53
364,24e3a9ee6129236287c8ce289e2bb7988b1f38547100f5433f4977c8bdcc1e82,249,5459070,24e3a9ee6129236287c8ce289e2bb7988b1f38547100f5433f4977c8bdcc1e82,249,5457500,1570,6.31
365,5ebbfcaaf94667cebe4e681a241c55f4214ad554b7e596795619268b68e8ada1,248,100000,5ebbfcaaf94667cebe4e681a241c55f4214ad554b7e596795619268b68e8ada1,248,94884,5116,20.63
366,5a1ba37ae585758c50e6a06d3784cc6839ed17bd832e47e1f43a5b92161a2886,372,1702770,5a1ba37ae585758c50e6a06d3784cc6839ed17bd832e47e1f43a5b92161a2886,372,1679718,23052,61.97
367,758bf503211b9dd55b2a242cd0d92ae322ba453e21c83ea629073eab13254216,226,993251,758bf503211b9dd55b2a242cd0d92ae322ba453e21c83ea629073eab13254216,226,986697,6554,29
368,f964191623baf5c792558060e0c88877bd834becc86590c508c1f2d547c6a2c9,487,428734,f964191623baf5c792558060e0c88877bd834becc86590c508c1f2d547c6a2c9,487,422720,6014,12.35
369,2b68324e3593723db559482de0dd5bbbe95098f3e7afd6f9416946550bdfa4e6,406,6434,2b68324e3593723db559482de0dd5bbbe95098f3e7afd6f9416946550bdfa4e6,406,5000,1434,3.53
370,63ed0dd7ef4f0c0b5a7b02d56f91aa7335d331a1345d24cd4b91dc0342f16b2d,221,272711,63ed0dd7ef4f0c0b5a7b02d56f91aa7335d331a1345d24cd4b91dc0342f16b2d,221,267818,4893,22.14
371,74b02715194a0c67ca61fa1635b1596f5badf45613f72e0431085c2192725c4d,372,2485285,74b02715194a0c67ca61fa1635b1596f5badf45613f72e0431085c2192725c4d,372,2476150,9135,24.56
372,3bd78360f907cd26d0953315fe1c18aca1b2321311fd93db41b4db44a57fa9c6,519,368067,3bd78360f907cd26d0953315fe1c18aca1b2321311fd93db41b4db44a57fa9c6,519,360839,7228,13.93
373,5e617bfd72c263d30cc2baff8e8d6cec34a25438a8c9b8fbfc8d16bae58ee2ca,247,1914492,5e617bfd72c263d30cc2baff8e8d6cec34a25438a8c9b8fbfc8d16bae58ee2ca,247,1913342,1150,4.66
374,71e325edabb72af293f1d71d552bf5d1642ad66c79e9bd19e1cb03345d39d32a,340,61712,71e325edabb72af293f1d71d552bf5d1642ad66c79e9bd19e1cb03345d39d32a,340,56521,5191,15.27
375,bb33843b7bee133af8e081a33887e1245e1983238ebba1e716c57fdb2d2f89dc,222,1558113,bb33843b7bee133af8e081a33887e1245e1983238ebba1e716c57fdb2d2f89dc,222,1557351,762,3.43
376,3326516fc0e5f833c94b453f556d98535ad8927b1b4c5c5f9b9a73ea6e164e39,367,10000,3326516fc0e5f833c94b453f556d98535ad8927b1b4c5c5f9b9a73ea6e164e39,367,8532,1468,4
377,38ec007cbd9f5b71cc8d10d6c6be0077d0c696f51ad733cf5fbc462750d79535,931,278775,38ec007cbd9f5b71cc8d10d6c6be0077d0c696f51ad733cf5fbc462750d79535,931,261360,17415,18.71
378,4c7ca1b0255bc3fb0750f318b8c7dcd8021a026bbd04e9b38d717064460c76d4,222,237633180,4c7ca1b0255bc3fb0750f318b8c7dcd8021a026bbd04e9b38d717064460c76d4,222,237630642,2538,11.43
379,def882ef00424f8de3c8ce24ad3d7b66f0b7f646079c0607c5d15f74e4f847ee,1031,5012777,def882ef00424f8de3c8ce24ad3d7b66f0b7f646079c0607c5d15f74e4f847ee,1031,4998900,13877,13.46
380,ef2a92dcc71aa1f038cc9770612b8b88a91b46c33a4c22b9e5795e50f44632a6,668,593979,ef2a92dcc71aa1f038cc9770612b8b88a91b46c33a4c22b9e5795e50f44632a6,668,583974,10005,14.98
381,41a2f76b3ca993ca89d4af82b2975363168022f9168bcefa6c19af5f8d86e985,1222,16853284,41a2f76b3ca993ca89d4af82b2975363168022f9168bcefa6c19af5f8d86e985,1222,16820913,32371,26.49
382,443cbcb811bd64739929f34f554c8c19b42caf7c727fb4aa4a2e7d6b0af3f3f4,405,6434,443cbcb811bd64739929f34f554c8c19b42caf7c727fb4aa4a2e7d6b0af3f3f4,405,5000,1434,3.54
383,c6b05293b7063f7ad3ccf094f2f2f40670055ac1d82bf7406e5f3e5d15f8dfa1,372,264995,c6b05293b7063f7ad3ccf094f2f2f40670055ac1d82bf7406e5f3e5d15f8dfa1,372,263534,1461,3.93
384,e98025890a0a4f4460eee0a60358a82fd079f18ed3483eab8e5d643bacaf16ff,248,421606,e98025890a0a4f4460eee0a60358a82fd079f18ed3483eab8e5d643bacaf16ff,248,416489,5117,20.63
385,16a58cd2ac9eb9302caaea2450474e2a636e716693a602a68de4e9874d39714e,312,266246,16a58cd2ac9eb9302caaea2450474e2a636e716693a602a68de4e9874d39714e,312,264974,1272,4.08
386,44869f6fc281508c05fb437624ba4336806e98034f48c05c18cfd2486afa5880,372,387126,44869f6fc281508c05fb437624ba4336806e98034f48c05c18cfd2486afa5880,372,385665,1461,3.93
387,4ec86b72acef4d0b6c5c5120a35138f9c732566b8aed5cdd94202597acbc1400,234,520396,4ec86b72acef4d0b6c5c5120a35138f9c732566b8aed5cdd94202597acbc1400,234,519564,832,3.56
388,af40c2897e72e86200f60d5c0d7faabb2d23eef0732f99375c362c2d8c13990e,189,63273,af40c2897e72e86200f60d5c0d7faabb2d23eef0732f99375c362c2d8c13990e,189,57856,5417,28.66
389,0221d43c7d2a3cfa3797ff4aaa2859cf8a2e69d7f006aeea49509bcc4af92b37,226,21290293,0221d43c7d2a3cfa3797ff4aaa2859cf8a2e69d7f006aeea49509bcc4af92b37,226,21284697,5596,24.76
390,358bca304c29c2bcf04d615b32afb62b3b68a14b3c9edb52aae0ce7495a4b0ee,328,1923,358bca304c29c2bcf04d615b32afb62b3b68a14b3c9edb52aae0ce7495a4b0ee,328,546,1377,4.2
391,c6fc210ae8ec90f8aedd5879c55b10cd39e14f62393c8812c6bc579ac165b937,195,718323,c6fc210ae8ec90f8aedd5879c55b10cd39e14f62393c8812c6bc579ac165b937,195,714223,4100,21.03
392,ee6262689de163200f2ea05006ca210b46786f95a83bb33d9d4594dcb3be1dce,223,15160122,ee6262689de163200f2ea05006ca210b46786f95a83bb33d9d4594dcb3be1dce,223,15152872,7250,32.51
393,0a3d589b0697ac59f53db2e80961e32cf9cd9c077bad0364a427a6bfe9e46700,279,7732,0a3d589b0697ac59f53db2e80961e32cf9cd9c077bad0364a427a6bfe9e46700,279,5088,2644,9.48
394,8d70be9e58c5a8993f7bdfd9acf0039aab2a76428f8c97da9d65d58fc571bbe3,506,100114,8d70be9e58c5a8993f7bdfd9acf0039aab2a76428f8c97da9d65d58fc571bbe3,506,90936,9178,18.14
395,90d6d2d3f20d9154164165b0b4ef2fe28e7ef262b6e688c073138ebaf46d6529,191,1308642,90d6d2d3f20d9154164165b0b4ef2fe28e7ef262b6e688c073138ebaf46d6529,191,1304542,4100,21.47
396,1badd58fa500ce55f7e56551ae3e08d1408fa830f179d7eb3f327c6da5a82c8b,191,10107878,1badd58fa500ce55f7e56551ae3e08d1408fa830f179d7eb3f327c6da5a82c8b,191,10105194,2684,14.05
397,55597a39f94f59a8579c5149f1da591759a578d53db74f1cabf9971194fcd786,406,3933,55597a39f94f59a8579c5149f1da591759a578d53db74f1cabf9971194fcd786,406,2500,1433,3.53
398,58a228861cb4520017fb629bb69e8bfe91a24a479b5d56764eb97e21ffc4ae72,195,1232980,58a228861cb4520017fb629bb69e8bfe91a24a479b5d56764eb97e21ffc4ae72,195,1230289,2691,13.8
399,59ef9e7e429a09c7fb7fcd9dcfbc8e47521657e1a876010f47d307651bb2fb5b,191,679000,59ef9e7e429a09c7fb7fcd9dcfbc8e47521657e1a876010f47d307651bb2fb5b,191,676140,2860,14.97
400,667cc4d3bb9c3c98ae2ddbbf8dba09808974093d7c8829fa69dc47e23bc4f668,154,5000,667cc4d3bb9c3c98ae2ddbbf8dba09808974093d7c8829fa69dc47e23bc4f668,154,4538,462,3
401,f2fdd8451698f85772b1d3e9a4b44f4de7bcdb655e3035164cef7b0ccac296db,223,50965,f2fdd8451698f85772b1d3e9a4b44f4de7bcdb655e3035164cef7b0ccac296db,223,47299,3666,16.44
402,488c29b1f5111f3bbda9ac8cfbf50929b29aa3742e429725c39c5c0bab2d9a60,355,1018537,488c29b1f5111f3bbda9ac8cfbf50929b29aa3742e429725c39c5c0bab2d9a60,355,1011921,6616,18.64
403,a64e3d32aa92c1dd93c3860d40689a6f3b93518563b032099cf1a32379191b0f,384,8620543,a64e3d32aa92c1dd93c3860d40689a6f3b93518563b032099cf1a32379191b0f,384,8609371,11172,29.09
404,c065c28f5a60b42d3e665ddc3bec9370afd950f30ee558ccef2077acaab5dc9c,193,29633,c065c28f5a60b42d3e665ddc3bec9370afd950f30ee558ccef2077acaab5dc9c,193,28528,1105,5.73
405,e85c7e887d0d28d2e65c7bb8a78395d6f9f9f7d451679706ae6c91add668e530,225,375179,e85c7e887d0d28d2e65c7bb8a78395d6f9f9f7d451679706ae6c91add668e530,225,368625,6554,29.13
406,069e64302e74b6755548a11cf14a09728c6fe9776c14d09782dff734bb2e6365,372,1999529092,069e64302e74b6755548a11cf14a09728c6fe9776c14d09782dff734bb2e6365,372,1999522069,7023,18.88
407,6b213d3229f3df4f37ef9ce15c5f9eb9a36766da0d2177f3dfdeb66e404b097f,353,1464773,6b213d3229f3df4f37ef9ce15c5f9eb9a36766da0d2177f3dfdeb66e404b097f,353,1458258,6515,18.46
408,963444027a83e30eedb60c4de51bf3472248377c606cce2e9cffe9502224a231,234,1146230,963444027a83e30eedb60c4de51bf3472248377c606cce2e9cffe9502224a231,234,1143920,2310,9.87
409,c625a0f6b7dc3060837a5ce8c046d51800800ee1ec9eb42d1c8aaa17369d88ae,222,7532285,c625a0f6b7dc3060837a5ce8c046d51800800ee1ec9eb42d1c8aaa17369d88ae,222,7528645,3640,16.4
410,26ad18b7caf59a2a24793a47ccb93ea8bd1e2b344b120fb256018f10f5043ff3,351,132041588,26ad18b7caf59a2a24793a47ccb93ea8bd1e2b344b120fb256018f10f5043ff3,351,132030290,11298,32.19
411,376b2475c7ab6e6dca1a31f38b353409b20cb4284037f288e8cba26dde9698ab,359,7000,376b2475c7ab6e6dca1a31f38b353409b20cb4284037f288e8cba26dde9698ab,359,5344,1656,4.61
412,536476e684da65e38fc2a6766f99bfb7329e1e9aac8cc0bc93df4294f0e6106b,223,1474004,536476e684da65e38fc2a6766f99bfb7329e1e9aac8cc0bc93df4294f0e6106b,223,1473018,986,4.42
413,5f25bdcb916c421ab87d3d07c244a25460dce24b71c1fcb9fe15807d9e861ce3,191,4642338,5f25bdcb916c421ab87d3d07c244a25460dce24b71c1fcb9fe15807d9e861ce3,191,4640160,2178,11.4
414,6405427d02ef2ad829e4f706bd84634f7fe208fb257a3b855b3d7b5fb4bbb6fc,246,3173132,6405427d02ef2ad829e4f706bd84634f7fe208fb257a3b855b3d7b5fb4bbb6fc,246,3168347,4785,19.45
415,6f7a44955782d8dbce800f78001af6bd3dee9f843b7d56f57f6f2aef3cf39b79,373,31431211,6f7a44955782d8dbce800f78001af6bd3dee9f843b7d56f57f6f2aef3cf39b79,373,31428923,2288,6.13
416,a33e9cf864428a057e110e220699062ac1c0c5a65ee936cef9e39a8edea5f0ed,478,1935402204,a33e9cf864428a057e110e220699062ac1c0c5a65ee936cef9e39a8edea5f0ed,478,1935393349,8855,18.53
417,428c75d1cf1b9c5fdbe58b40677ffaddbc13b5218922debacf1e1b0b9136cce1,154,2500,428c75d1cf1b9c5fdbe58b40677ffaddbc13b5218922debacf1e1b0b9136cce1,154,1884,616,4
418,8bcda9f56faf0bba6b1622e66d4d596aee674a97ca7c260809e80d7e2d732509,225,124275,8bcda9f56faf0bba6b1622e66d4d596aee674a97ca7c260809e80d7e2d732509,225,118399,5876,26.12
419,ed0d644994f2c40a6592476da5410d9010837ff979afc62030ddfb99811723f5,382,45188281,ed0d644994f2c40a6592476da5410d9010837ff979afc62030ddfb99811723f5,382,45182889,5392,14.12
420,0589d2e8934025311496968c973ab158aec1362a80d13d9d7503f275730642ca,223,2567637,0589d2e8934025311496968c973ab158aec1362a80d13d9d7503f275730642ca,223,2563816,3821,17.13
421,30039a1c14786c7b05bca73ce8b6393de6cfb33317ca4d5b1cc1d64493653a72,222,718559,30039a1c14786c7b05bca73ce8b6393de6cfb33317ca4d5b1cc1d64493653a72,222,714893,3666,16.51
422,41e0b3ca87dcb61dc9032d1711c3612329f78234d87b45fa77d5d7f503592ddf,57564,96772,41e0b3ca87dcb61dc9032d1711c3612329f78234d87b45fa77d5d7f503592ddf,57564,10000,86772,1.51
423,cc6976ba3af5b07b053f78d935f92c2306d677ad77b8c0e6981c5fa865c563bf,223,52830,cc6976ba3af5b07b053f78d935f92c2306d677ad77b8c0e6981c5fa865c563bf,223,49647,3183,14.27
424,0f48761738b86971dd5c08e18595108cfef6a4dc9aae5d5a2c5fc4911cfc102a,191,853829,0f48761738b86971dd5c08e18595108cfef6a4dc9aae5d5a2c5fc4911cfc102a,191,850969,2860,14.97
425,482800106c4cc9591f46e843e20c9b18834fd57b83c34b89085fc682f1a0385d,223,55610,482800106c4cc9591f46e843e20c9b18834fd57b83c34b89085fc682f1a0385d,223,51578,4032,18.08
426,a7f523d1866ccfb53ecda0f85fd8a2ce0c4d9919c5cac6cb534da92a05e1d54a,222,1266950,a7f523d1866ccfb53ecda0f85fd8a2ce0c4d9919c5cac6cb534da92a05e1d54a,222,1265971,979,4.41
427,dc2dec1b4c5a131f902a34c74eeeaee2b5616540057f9dfb543bf45c205d727f,154,5000,dc2dec1b4c5a131f902a34c74eeeaee2b5616540057f9dfb543bf45c205d727f,154,4384,616,4
428,f4168459cf9a06f222f5bf0890913e735bca206bae47d66d25f6d36585d71c0b,450,2359858,f4168459cf9a06f222f5bf0890913e735bca206bae47d66d25f6d36585d71c0b,450,2352214,7644,16.99
429,01aa9dbf1c13152cd201946c0fc0a5c80b713954913d498a2fa6e608ad87a91d,335,4375,01aa9dbf1c13152cd201946c0fc0a5c80b713954913d498a2fa6e608ad87a91d,335,3524,851,2.54
430,22b099a3f438b2cf6f6b5320cfa07eb3920e01498c1f42f18df863323cb98020,1360,59125714,22b099a3f438b2cf6f6b5320cfa07eb3920e01498c1f42f18df863323cb98020,1360,59099124,26590,19.55
431,265d80d74a04064a276af78958efcc8443364a48500203cb5f74ba515a29e47e,223,85099,265d80d74a04064a276af78958efcc8443364a48500203cb5f74ba515a29e47e,223,84113,986,4.42
432,27de8fc4242007db01adfa69d3f6a07321cbf07ac0901bdb9c1965ee3fc46797,549,1645744,27de8fc4242007db01adfa69d3f6a07321cbf07ac0901bdb9c1965ee3fc46797,549,1635765,9979,18.18
433,8c961c04f8e9d9b3d2ffa456300d878f359cab0c8246da0d524f8889582bb901,1074,3539721,8c961c04f8e9d9b3d2ffa456300d878f359cab0c8246da0d524f8889582bb901,1074,3522441,17280,16.09
434,9ecbabc9eb6f824d9d2e4391f4e3226c726d862b39e3d170d674ad4ca4ccd471,223,6822117,9ecbabc9eb6f824d9d2e4391f4e3226c726d862b39e3d170d674ad4ca4ccd471,223,6816898,5219,23.4
435,a2172a83fe6b3ab3b1d795eabfb43acb817ab09396a2b4b1b2cc2db4531f1ce3,312,62054,a2172a83fe6b3ab3b1d795eabfb43acb817ab09396a2b4b1b2cc2db4531f1ce3,312,61418,636,2.04
436,bb885278b1ca06e7c6bfa4aa38fd776e7488100e371e6f03738b095a2d704f34,224,73057,bb885278b1ca06e7c6bfa4aa38fd776e7488100e371e6f03738b095a2d704f34,224,70887,2170,9.69
437,ce839888e2d453301c980aae18611ff59b5807df216220db7099f64497a61ae6,223,98352,ce839888e2d453301c980aae18611ff59b5807df216220db7099f64497a61ae6,223,94686,3666,16.44
438,dffcb2db11053681ec8b6121ba7b03ddf415de7bd10f2e7a268fc82af7e41541,192,379613,dffcb2db11053681ec8b6121ba7b03ddf415de7bd10f2e7a268fc82af7e41541,192,376838,2775,14.45
439,e30893103d3752e0e8537eb97506a2408de173fdacf8d50f12948a37ff99c4c8,226,749196,e30893103d3752e0e8537eb97506a2408de173fdacf8d50f12948a37ff99c4c8,226,745452,3744,16.57
440,e52a5a8e292c24ca1d46e7aa921fd1a968a448de0437f77f899d0c7738d9b17f,537,485747,e52a5a8e292c24ca1d46e7aa921fd1a968a448de0437f77f899d0c7738d9b17f,537,483593,2154,4.01
441,5f9766b974ab2d32eb14b3ada189406a5e24e23df1f34cfa8c31e834d680b588,405,3933,5f9766b974ab2d32eb14b3ada189406a5e24e23df1f34cfa8c31e834d680b588,405,2500,1433,3.54
442,a32bdf41d06033a7b4d51350b1f4816817fc25941cc5b7bb9ea7f19f25b58289,193,339000,a32bdf41d06033a7b4d51350b1f4816817fc25941cc5b7bb9ea7f19f25b58289,193,336114,2886,14.95
443,bf1ec1ac31f4d6e36f90d9ac41e0f4600606e055e7ed9a63519742634dda917a,247,147451,bf1ec1ac31f4d6e36f90d9ac41e0f4600606e055e7ed9a63519742634dda917a,247,145283,2168,8.78
444,e31c4eac9ebbe17eb24c6a1004f5bc0e0c4002b6465bbaf0b2383ca429b81779,151,5000,e31c4eac9ebbe17eb24c6a1004f5bc0e0c4002b6465bbaf0b2383ca429b81779,151,4396,604,4
445,e34b8f0e1b008004efc26a59241356405bda75795db594b1ffd174134c9dd1ce,317,1818,e34b8f0e1b008004efc26a59241356405bda75795db594b1ffd174134c9dd1ce,317,546,1272,4.01
446,f02c34ff4ba7630ffeeffe6c9b957d5b0b6fcec9607b99c7df7c5a9086b39e8e,1825,37542124,f02c34ff4ba7630ffeeffe6c9b957d5b0b6fcec9607b99c7df7c5a9086b39e8e,1825,37519816,22308,12.22
447,774dd320ee7204149d389ada17e24ce0e90234d7aa2c8189e33bf04a42118a81,192,125287,774dd320ee7204149d389ada17e24ce0e90234d7aa2c8189e33bf04a42118a81,192,119748,5539,28.85
448,99b9ab4fed35fa0184eebd52a2cfca43e3f0297829a7c1065394a00f146a1b1c,191,960000,99b9ab4fed35fa0184eebd52a2cfca43e3f0297829a7c1065394a00f146a1b1c,191,957140,2860,14.97
449,a4f2cffbafed14accc1cf56e54559c85b80cb28bd4fbb7b3b43f5fe1424148d1,285,48226546,a4f2cffbafed14accc1cf56e54559c85b80cb28bd4fbb7b3b43f5fe1424148d1,285,48219406,7140,25.05
450,de117caa6219b4918f1c450e4c80dcad0245f07d45220dcc583de63f26e05f89,206,6617012,de117caa6219b4918f1c450e4c80dcad0245f07d45220dcc583de63f26e05f89,206,6616370,642,3.12
451,ea12cdb9a06d059d88b0f7536e916c7d6adb7dd40dc6cf22701fd20a5c5a416f,195,331189,ea12cdb9a06d059d88b0f7536e916c7d6adb7dd40dc6cf22701fd20a5c5a416f,195,328251,2938,15.07
452,0ede3540d81e9bc844c79c017b40160b7209036a18d7c7fe330039d9785ecc80,222,868489,0ede3540d81e9bc844c79c017b40160b7209036a18d7c7fe330039d9785ecc80,222,864491,3998,18.01
453,25899594ece1f98d164b55aa1cd819b8e52f3d7ca60008fa91c75d9158866af9,223,82000,25899594ece1f98d164b55aa1cd819b8e52f3d7ca60008fa91c75d9158866af9,223,78334,3666,16.44
454,516ea907e3dbbf1e76e030c573fb72d2d699f624670d83e93229a1311baf54d6,154,5000,516ea907e3dbbf1e76e030c573fb72d2d699f624670d83e93229a1311baf54d6,154,4384,616,4
455,a460023b3fc333d113b2a1a952a494ba521b60157bffd45acd8ac91181945349,248,1383501,a460023b3fc333d113b2a1a952a494ba521b60157bffd45acd8ac91181945349,248,1378384,5117,20.63
456,bba9e333ef519eeb3df36d51b49388368893d6c91459f39b19df8c75de454dd6,348,79909689,bba9e333ef519eeb3df36d51b49388368893d6c91459f39b19df8c75de454dd6,348,79907665,2024,5.82
457,c99bab72ec43d98bea24770e0763b02d3786fd2dd7d476a8baa79838855028a0,344,497037,c99bab72ec43d98bea24770e0763b02d3786fd2dd7d476a8baa79838855028a0,344,495775,1262,3.67
458,23aa0b94c841f94a227c08e149428d79e62608547a469da91334e6605e1d2fa3,488,1944072,23aa0b94c841f94a227c08e149428d79e62608547a469da91334e6605e1d2fa3,488,1937650,6422,13.16
459,3427d7a21bd46dc530c1a572931164fff35049700cf547fab4c23b8544a349d0,190,80243,3427d7a21bd46dc530c1a572931164fff35049700cf547fab4c23b8544a349d0,190,77518,2725,14.34
460,608581bd6483d3f9aa0bf71310d290bc4ddb462885a5275f4639b4e67e5e6b61,246,83982,608581bd6483d3f9aa0bf71310d290bc4ddb462885a5275f4639b4e67e5e6b61,246,77419,6563,26.68
461,f68031f45638d0be7969b1bd7bd34a60a885f7de304d541c840d42b7bef66abd,248,262000,f68031f45638d0be7969b1bd7bd34a60a885f7de304d541c840d42b7bef66abd,248,256883,5117,20.63
462,07c7dacf81af7a227d1204f67528e0e3b78663a27e7ebf0f4fa272c9b6225bb2,223,8225195,07c7dacf81af7a227d1204f67528e0e3b78663a27e7ebf0f4fa272c9b6225bb2,223,8220313,4882,21.89
463,16161c9a606162eee96da46ddb00f804a36fd9500c83c6c90f05fc03c43f0bdd,195,82192,16161c9a606162eee96da46ddb00f804a36fd9500c83c6c90f05fc03c43f0bdd,195,81404,788,4.04
464,2bbc249d04d4402d9f3cea0eeab4f94a490c1d41fe5b1d86c28adc1a0dfcf58d,285,12041606,2bbc249d04d4402d9f3cea0eeab4f94a490c1d41fe5b1d86c28adc1a0dfcf58d,285,12035486,6120,21.47
465,912ada99499a0c9c345c894d6ffed9895a105b54e90d22aa76c4a08872a2a057,223,2082895,912ada99499a0c9c345c894d6ffed9895a105b54e90d22aa76c4a08872a2a057,223,2079430,3465,15.54
466,f0ecc4d284f82b735dc4d220c84cce94757a6c7bc31dd5b772e146392722885e,372,140304,f0ecc4d284f82b735dc4d220c84cce94757a6c7bc31dd5b772e146392722885e,372,134844,5460,14.68
467,2706edbe1f393fea724090340b7511365ad8c31b253afda1dc7274e5f708f345,631,2312514,2706edbe1f393fea724090340b7511365ad8c31b253afda1dc7274e5f708f345,631,2302338,10176,16.13
468,280c81a0f05fc8bca9b8dae9a5db603b4fcd9925a6f995c375b54c84e6febea3,224,677625,280c81a0f05fc8bca9b8dae9a5db603b4fcd9925a6f995c375b54c84e6febea3,224,674493,3132,13.98
469,441b536f79ee2d2fec702807993d630104a23cdcc1aa6e60aaa35752bcdad5a4,371,670866,441b536f79ee2d2fec702807993d630104a23cdcc1aa6e60aaa35752bcdad5a4,371,667135,3731,10.06
470,b40b923e8d12d966fcf98c627c22f29c2bcf52d0ab11a097e25875adb6f399eb,222,328473632,b40b923e8d12d966fcf98c627c22f29c2bcf52d0ab11a097e25875adb6f399eb,222,328470186,3446,15.52
471,bf27ac9579dbc62c8b3c8284cfc95939b030d758be3a9446e8cd94678115ec0b,223,8577195,bf27ac9579dbc62c8b3c8284cfc95939b030d758be3a9446e8cd94678115ec0b,223,8571570,5625,25.22
472,0c655f99ef98b5d01a58bdd75f3c1130567c88556b0d09a0844d88961014d788,370,3816430,0c655f99ef98b5d01a58bdd75f3c1130567c88556b0d09a0844d88961014d788,370,3808342,8088,21.86
473,18db7ddcf81646a4c4c5f501a19332d3a2f2e062d5dc05727add5fb3149cdb35,223,361418145,18db7ddcf81646a4c4c5f501a19332d3a2f2e062d5dc05727add5fb3149cdb35,223,361414505,3640,16.32
474,1bdd6ca5d7478f2c405ec0a8949cc56ebf563f38b7184cb3ef2eba308d4b8eb0,223,2754167,1bdd6ca5d7478f2c405ec0a8949cc56ebf563f38b7184cb3ef2eba308d4b8eb0,223,2750114,4053,18.17
475,382fceb7662069399c05c200e835da250d5bf4c0ed2bccb200b017d8f22e2e16,191,1802725,382fceb7662069399c05c200e835da250d5bf4c0ed2bccb200b017d8f22e2e16,191,1801829,896,4.69
476,4c5fb9d71c7b260d303e5abfe4569e3dd298d1192d5353604fcde6aaf9d0a43f,226,849792,4c5fb9d71c7b260d303e5abfe4569e3dd298d1192d5353604fcde6aaf9d0a43f,226,848792,1000,4.42
477,891409bfd98762655ed6053ac1d7d20176552c040831df96f4f8a016928417f6,195,3601697,891409bfd98762655ed6053ac1d7d20176552c040831df96f4f8a016928417f6,195,3598759,2938,15.07
478,96b8def727603f9d9ca88ec6f63af2aa75e96326248da8856e322b77dafaea23,824,181193546,96b8def727603f9d9ca88ec6f63af2aa75e96326248da8856e322b77dafaea23,824,181183018,10528,12.78
479,ad5ee7db645d6b2685d2968e5928ee78831a768e7701814b4cc318c8b737889c,666,14509524,ad5ee7db645d6b2685d2968e5928ee78831a768e7701814b4cc318c8b737889c,666,14498804,10720,16.1
480,b483ad2800090f511ec5c5e7c8ab0bab5e3ec332673cf281e847d7e9251ddc97,374,354620,b483ad2800090f511ec5c5e7c8ab0bab5e3ec332673cf281e847d7e9251ddc97,374,352725,1895,5.07
481,118920d1d50760f8306fdca079e61aa613264c9e27608c33a6cc7780918ce161,225,64783,118920d1d50760f8306fdca079e61aa613264c9e27608c33a6cc7780918ce161,225,61039,3744,16.64
482,23058b46ff5a60c6e04f0755e8cbd8da3fd3f152cd2a5c8d5dff8ad25d6581fd,223,361418,23058b46ff5a60c6e04f0755e8cbd8da3fd3f152cd2a5c8d5dff8ad25d6581fd,223,357752,3666,16.44
483,43fb34eeb655dbf9708fbb7a70c8e1597a600a5065a9c4843057bee852447464,248,1085886,43fb34eeb655dbf9708fbb7a70c8e1597a600a5065a9c4843057bee852447464,248,1081902,3984,16.06
484,570395fd2712785e4882da11cae8198eb9858990d0f22f71f1bed035d676b14f,406,3934,570395fd2712785e4882da11cae8198eb9858990d0f22f71f1bed035d676b14f,406,2500,1434,3.53
485,7556898493eee058af69d155b8d54127308c42d8eb4f01c09adfc1cae1ba8311,2811,10501209945,7556898493eee058af69d155b8d54127308c42d8eb4f01c09adfc1cae1ba8311,2811,10501172445,37500,13.34
486,a02c7b6ac1923788589558083d150f6a1854a88ec10e3a57479dfc9a1aa06a98,223,52820,a02c7b6ac1923788589558083d150f6a1854a88ec10e3a57479dfc9a1aa06a98,223,50136,2684,12.04
487,af9d93301aaa4c46728a3d04a0cad7f56fe5cfc6bf9ee1040e3429d4dea62d5a,484,623915,af9d93301aaa4c46728a3d04a0cad7f56fe5cfc6bf9ee1040e3429d4dea62d5a,484,616107,7808,16.13
488,b1c772bf30d39520c0797c3a3b56482db93cb83bcdbc4f728535db87da324298,225,335000,b1c772bf30d39520c0797c3a3b56482db93cb83bcdbc4f728535db87da324298,225,331256,3744,16.64
489,e3cb5a2c0790cc1e142a66feca8d0d31aab547e2812e2580cd2064c1fca8d01e,162,10484,e3cb5a2c0790cc1e142a66feca8d0d31aab547e2812e2580cd2064c1fca8d01e,162,9485,999,6.17
490,ef769db585f0e47b37fdf7356f523700ddd448d5aac63a60469f17ddb5442bcf,344,541055,ef769db585f0e47b37fdf7356f523700ddd448d5aac63a60469f17ddb5442bcf,344,535835,5220,15.17
491,f5c3b9569bc352c92813075abafb553ad88e590b33f39e9f400b5c0174d7e778,223,100213165,f5c3b9569bc352c92813075abafb553ad88e590b33f39e9f400b5c0174d7e778,223,100207515,5650,25.34
492,0904bf90a6f290dc3426a3f6cf046cfb2b1db8626dfb500254d8ec3a3ba993a2,370,7419024,0904bf90a6f290dc3426a3f6cf046cfb2b1db8626dfb500254d8ec3a3ba993a2,370,7413628,5396,14.58
493,26111b142966c09f37c7ca6e5b48c6bd9f51babda11c3bf3018e0c7a199650b6,223,6884241,26111b142966c09f37c7ca6e5b48c6bd9f51babda11c3bf3018e0c7a199650b6,223,6881872,2369,10.62
494,26dbe659214ab1ec546d32e81e48854c118ef7a78f73e8c4dabf4d30deb45a4b,217,2000000000,26dbe659214ab1ec546d32e81e48854c118ef7a78f73e8c4dabf4d30deb45a4b,217,1999990100,9900,45.62
495,7fa8cbefc5d87c2f83c8111bbf25c86bccc578a33f25db467a06bcaadfcbb2ea,469,17746352,7fa8cbefc5d87c2f83c8111bbf25c86bccc578a33f25db467a06bcaadfcbb2ea,469,17737142,9210,19.64
496,8b6b649cf4171d87bad7ba8ab64beb7bd8f63ac47357528a607cabe4f1c4d7b7,369,1540579,8b6b649cf4171d87bad7ba8ab64beb7bd8f63ac47357528a607cabe4f1c4d7b7,369,1538484,2095,5.68
497,eee122f70141924188a394aae7b81994090311554585cc678f2f79802e7284cc,370,410596,eee122f70141924188a394aae7b81994090311554585cc678f2f79802e7284cc,370,400770,9826,26.56
498,02906a6e0295f2e0281ede114a50a50ebb127512f1aad89b89a82856bd06e246,506,98915,02906a6e0295f2e0281ede114a50a50ebb127512f1aad89b89a82856bd06e246,506,89737,9178,18.14
499,3a9e6b07713fd65a867797a88661465eb1c94bdd4d0ce31783cee8e54c3b4d96,193,543933,3a9e6b07713fd65a867797a88661465eb1c94bdd4d0ce31783cee8e54c3b4d96,193,541047,2886,14.95
500,b794a968b55237b3ac8f33fde225d8656b840715fcef780ca38a97c13fe2631a,342,312248,b794a968b55237b3ac8f33fde225d8656b840715fcef780ca38a97c13fe2631a,342,306218,6030,17.63
501,c8c5e7777dd127ba3cc89dcbc86d0f176d76927e955541c88eac8c4dc3ca8578,224,551521,c8c5e7777dd127ba3cc89dcbc86d0f176d76927e955541c88eac8c4dc3ca8578,224,550752,769,3.43
502,f450cd8a6266565e3d62c15556ffddbc1d134872c84f650957afd300e1cd5976,222,1827300,f450cd8a6266565e3d62c15556ffddbc1d134872c84f650957afd300e1cd5976,222,1826300,1000,4.5
503,1baf2857b36f1db6aa98e049093807098c64ddb79311b1de4c8c9a3649805d56,195,305376,1baf2857b36f1db6aa98e049093807098c64ddb79311b1de4c8c9a3649805d56,195,303116,2260,11.59
504,2a2c24d129daca5314d9fc99a371a0e70bb4a23715a1490f4f41d8e0eb43009b,1925,99970000,2a2c24d129daca5314d9fc99a371a0e70bb4a23715a1490f4f41d8e0eb43009b,1925,99922411,47589,24.72
505,48c4b14a8938cd0e89285ccd19bd3c7367825ad931c282c4bb0ed3df31c49699,248,7000000,48c4b14a8938cd0e89285ccd19bd3c7367825ad931c282c4bb0ed3df31c49699,248,6992998,7002,28.23
506,f5e9601dcf6955478650c21d4728f48d483baa2c3286db9749a4c5a9727fb919,223,98992,f5e9601dcf6955478650c21d4728f48d483baa2c3286db9749a4c5a9727fb919,223,95352,3640,16.32
507,1d63acfbeac978c6fe55a708281cf2764111a4a64d9bf3a3dedd63bdf073f086,933,4328119410,1d63acfbeac978c6fe55a708281cf2764111a4a64d9bf3a3dedd63bdf073f086,933,4328106466,12944,13.87
508,1f12870954a50f264ce3039798d221928448d9ff071cbe64662352b58d6c3eab,534,8190990,1f12870954a50f264ce3039798d221928448d9ff071cbe64662352b58d6c3eab,534,8163390,27600,51.69
509,27ea3019f0f9dd57df1493b4d4502da7c297269a5e59a3586dfa7be27700bffc,222,6893891,27ea3019f0f9dd57df1493b4d4502da7c297269a5e59a3586dfa7be27700bffc,222,6889451,4440,20
510,49c47c1ee4568a57b9f735aa6f34385eda3a45c3d8f235df89382eb185864585,223,617438,49c47c1ee4568a57b9f735aa6f34385eda3a45c3d8f235df89382eb185864585,223,614773,2665,11.95
511,be8d30b49ab2fe6a6c1b5bddf2c2e4128826926411b1e34bb2ebfef3ad99c673,191,95645,be8d30b49ab2fe6a6c1b5bddf2c2e4128826926411b1e34bb2ebfef3ad99c673,191,90015,5630,29.48
512,f35b85b67cb54499cb026ecfb163178e382521d108d0e5fc840b710f65d12f45,648,15705968,f35b85b67cb54499cb026ecfb163178e382521d108d0e5fc840b710f65d12f45,648,15699083,6885,10.62
513,f3aaafd80779e61c051aac04dc3b47428571c70f7529e95f6e3d710f1364b9f8,195,1831792,f3aaafd80779e61c051aac04dc3b47428571c70f7529e95f6e3d710f1364b9f8,195,1830894,898,4.61
514,0960bf9b94303c2e905d4fbad3557186c1553e2e6ae6dc3a03359a943c366b1f,372,198039,0960bf9b94303c2e905d4fbad3557186c1553e2e6ae6dc3a03359a943c366b1f,372,196585,1454,3.91
515,ba110b30ee95c3db6f5d8cc5a6a1ed484cc6f8b97598da6f2a5d9588539c7b57,338,391861,ba110b30ee95c3db6f5d8cc5a6a1ed484cc6f8b97598da6f2a5d9588539c7b57,338,386081,5780,17.1
516,082ecb6f72501e036e0e8ccaf28ca402e1df67274319b20271d0e35b17bb0846,518,89954,082ecb6f72501e036e0e8ccaf28ca402e1df67274319b20271d0e35b17bb0846,518,76434,13520,26.1
517,1245a8c7338d27bcb61ad9f39d2c04f928b3b94408f46dc532a05e2b13acd612,222,2289623,1245a8c7338d27bcb61ad9f39d2c04f928b3b94408f46dc532a05e2b13acd612,222,2286803,2820,12.7
518,53c41dd80c391499f582704afb271818624eb1bf80408e146b545d03f1a4589b,247,2679582,53c41dd80c391499f582704afb271818624eb1bf80408e146b545d03f1a4589b,247,2678500,1082,4.38
519,cd573e00c8c7ce38ee536318a52c477e205b6ae2ed92bfad0bd666f9415a7977,193,463986,cd573e00c8c7ce38ee536318a52c477e205b6ae2ed92bfad0bd666f9415a7977,193,461100,2886,14.95
520,fe25a2d69f83a2361c7924341a08459f2e0d0ae9c907d3a22ee056d8e2d4d03f,226,212682,fe25a2d69f83a2361c7924341a08459f2e0d0ae9c907d3a22ee056d8e2d4d03f,226,197484,15198,67.25
521,41533c80fe2ddfc98332c3a040efa76bb58b01d885c9cc24037c2a1875e42584,194,26888,41533c80fe2ddfc98332c3a040efa76bb58b01d885c9cc24037c2a1875e42584,194,24650,2238,11.54
522,5c7673b25fe38af5a163b265c212228310addb79bc76635e0f33e94ececda5f3,223,139447695,5c7673b25fe38af5a163b265c212228310addb79bc76635e0f33e94ececda5f3,223,139441731,5964,26.74
523,a25d38955677b6d8bc0a2716c5c203c898d2de0c1822f506e98d9850ea321d91,222,898196,a25d38955677b6d8bc0a2716c5c203c898d2de0c1822f506e98d9850ea321d91,222,894143,4053,18.26
524,bea699c8ae81e66ba417b477dff7a67aedbf318e082bbbd92f6b8dea7faa7bea,816,9627683,bea699c8ae81e66ba417b477dff7a67aedbf318e082bbbd92f6b8dea7faa7bea,816,9618554,9129,11.19
525,fc1cce77641035dbc59f4350136db8911c4c7433d4220a9fabca0ebc7c460ba7,225,625813,fc1cce77641035dbc59f4350136db8911c4c7433d4220a9fabca0ebc7c460ba7,225,619861,5952,26.45
526,14c2626d82b26522a34e0d63747838f8bca4f76cb811cf1dcfc2c6f887dcaa09,222,526864,14c2626d82b26522a34e0d63747838f8bca4f76cb811cf1dcfc2c6f887dcaa09,222,523198,3666,16.51
527,27d638d929f11672e30f0b82764717a378bca96a56675b05d07f0d18354085b9,370,1134675,27d638d929f11672e30f0b82764717a378bca96a56675b05d07f0d18354085b9,370,1131137,3538,9.56
528,3cc0e0b0b2aba675dc0e7d2c335787bda5781d21878da714b7609ece35810620,345,44893167,3cc0e0b0b2aba675dc0e7d2c335787bda5781d21878da714b7609ece35810620,345,44892262,905,2.62
529,2bdd2f35211ee9d592eca7214689d712d03d094d5721db5070808eae39395903,492,285254,2bdd2f35211ee9d592eca7214689d712d03d094d5721db5070808eae39395903,492,278780,6474,13.16
530,2d4acdd919250823365b7421b4fe732dbf7606a10a2ed8412ba9d518a6c5c5f2,248,265889,2d4acdd919250823365b7421b4fe732dbf7606a10a2ed8412ba9d518a6c5c5f2,248,260772,5117,20.63
531,496fa08549657634198b52c4ab9e8dc9b4e03d867f93003a06f3d294816cc727,315,75532309,496fa08549657634198b52c4ab9e8dc9b4e03d867f93003a06f3d294816cc727,315,75526272,6037,19.17
532,63f0013b016d570ab052dd5227d2f744f428c17b5d8b35a51bcf105a2e427534,515,2109244,63f0013b016d570ab052dd5227d2f744f428c17b5d8b35a51bcf105a2e427534,515,2105604,3640,7.07
533,dfe4db0943cc13a82751fa2a2bed7bc437ef4bd4a57768accb6cac55ddeb5946,1918,24000000,dfe4db0943cc13a82751fa2a2bed7bc437ef4bd4a57768accb6cac55ddeb5946,1918,23952592,47408,24.72
534,4289009d1a3dc9371ba58a15b397fe72f7dcc78c732f2b617e96f843a4773ad0,217,880582,4289009d1a3dc9371ba58a15b397fe72f7dcc78c732f2b617e96f843a4773ad0,217,876638,3944,18.18
535,79116a5187eb3d1bbd0c3ddffe79ed10bc3a2f190b15eaeb74b030e5ae353fc3,234,3184799,79116a5187eb3d1bbd0c3ddffe79ed10bc3a2f190b15eaeb74b030e5ae353fc3,234,3183036,1763,7.53
536,9199304a207fa8a1b88df750d098b91f391040d1e119f77e1ae467218122cbca,406,6433,9199304a207fa8a1b88df750d098b91f391040d1e119f77e1ae467218122cbca,406,5000,1433,3.53
537,a5047e5b1f82c94f5625e7f242865da3d3973f1d1fb426c1e2353de38adbd446,371,157392,a5047e5b1f82c94f5625e7f242865da3d3973f1d1fb426c1e2353de38adbd446,371,151932,5460,14.72
538,b6106115373e9c2cf075f8451bffff5eefb1a2b93c70f1533296c1a92e65a18b,269,45243,b6106115373e9c2cf075f8451bffff5eefb1a2b93c70f1533296c1a92e65a18b,269,44229,1014,3.77
539,bb3330e4d5e45e72b3ed97490041d3d46ee9002069f4ade401020e93d6291464,223,3390453,bb3330e4d5e45e72b3ed97490041d3d46ee9002069f4ade401020e93d6291464,223,3386393,4060,18.21
540,f75e50bd305b007580435405c07f3aed5ed7e956cd7583dea505fdd697318282,223,25984258,f75e50bd305b007580435405c07f3aed5ed7e956cd7583dea505fdd697318282,223,25978476,5782,25.93
541,01b3211c2c255f5a2aaa6f869fd2099ad712186fb24b2f34864d5fdfb4392877,222,1843949,01b3211c2c255f5a2aaa6f869fd2099ad712186fb24b2f34864d5fdfb4392877,222,1842970,979,4.41
542,084635271924dff949cb102e75863a5f81e38e9995abbb1c3fa21fe3710462ed,223,41721,084635271924dff949cb102e75863a5f81e38e9995abbb1c3fa21fe3710462ed,223,36071,5650,25.34
543,115b46ed85ee9a3dcd0db8e2380c6841fd4b0cac131ad611a14691251e7c3032,194,163722,115b46ed85ee9a3dcd0db8e2380c6841fd4b0cac131ad611a14691251e7c3032,194,160784,2938,15.14
544,a5c07b588e0b359108622a3e26bfb06819b9d7079d9eeb944425c621d8a573cc,191,530719,a5c07b588e0b359108622a3e26bfb06819b9d7079d9eeb944425c621d8a573cc,191,527859,2860,14.97
545,c9f513fe495e05d77a804b54b94dfc4d3ce7b8771a53f4cf37c9db89a6ac3424,222,2488749,c9f513fe495e05d77a804b54b94dfc4d3ce7b8771a53f4cf37c9db89a6ac3424,222,2482827,5922,26.68
546,e682d2b44ebc16c1a38c2989ada493449f27b164c3668966a7b8f8e4c7b03259,189,800170,e682d2b44ebc16c1a38c2989ada493449f27b164c3668966a7b8f8e4c7b03259,189,797089,3081,16.3
547,067d1b6c46a270787e9d7ce1c165105fec60724a44f77acd93a2896bf49d2dbe,194,297715,067d1b6c46a270787e9d7ce1c165105fec60724a44f77acd93a2896bf49d2dbe,194,295477,2238,11.54
548,1ffcbcbd70e73e7760adcded9f8b8e5e8c0c3a2558720ca792c6882ff3a301cb,339,2397300,1ffcbcbd70e73e7760adcded9f8b8e5e8c0c3a2558720ca792c6882ff3a301cb,339,2390000,7300,21.53
549,3ed8fbfa66097fd955d2d19247b29afeee2a6938075edf2768042cc826f7b63a,372,3526954,3ed8fbfa66097fd955d2d19247b29afeee2a6938075edf2768042cc826f7b63a,372,3520907,6047,16.26
550,5eebda016f35bb161771b519970ed690c4ff0cc76e85b7e652f83803d1ac6811,192,149786,5eebda016f35bb161771b519970ed690c4ff0cc76e85b7e652f83803d1ac6811,192,147480,2306,12.01
551,de21a45f64d237eefca69d0e56382874c1612c4336848aaadfe5227d19dec0d8,672,121350,de21a45f64d237eefca69d0e56382874c1612c4336848aaadfe5227d19dec0d8,672,112289,9061,13.48
552,4572430dc7b904626ff5b8dd3d7bc5401da7e02b6169ebbbcd80557c3e618823,192,428318,4572430dc7b904626ff5b8dd3d7bc5401da7e02b6169ebbbcd80557c3e618823,192,425654,2664,13.88
553,81f1c14f397282ea5591dbe9e31191b79d87b3ee0023c64863a016ac2a352db5,191,138347,81f1c14f397282ea5591dbe9e31191b79d87b3ee0023c64863a016ac2a352db5,191,129370,8977,47
554,00e000f79647a5c476547ac9b3a864b01cc4894f3d4cb30725692bb65cdfb5e6,373,681936,00e000f79647a5c476547ac9b3a864b01cc4894f3d4cb30725692bb65cdfb5e6,373,676502,5434,14.57
555,15588a48cb932bdcd5484cf63ff4db0f9860b0f2172c4f55532aee596afb7acf,195,332398,15588a48cb932bdcd5484cf63ff4db0f9860b0f2172c4f55532aee596afb7acf,195,329460,2938,15.07
556,305345896c03532b2de3eccb23361aeaf6c8a703109b7bc4dca32c489213a53f,194,73087,305345896c03532b2de3eccb23361aeaf6c8a703109b7bc4dca32c489213a53f,194,69813,3274,16.88
557,4e081c7a401393f8e69d968f5600f0525bc915c047c1206f7d8fdf998f5155b9,519,5075788,4e081c7a401393f8e69d968f5600f0525bc915c047c1206f7d8fdf998f5155b9,519,5067805,7983,15.38
558,6b35abc0a65b4fabb07f93b62915d79b7a58f57f21499ab7af2a9ba99f68f043,482,1763973,6b35abc0a65b4fabb07f93b62915d79b7a58f57f21499ab7af2a9ba99f68f043,482,1760687,3286,6.82
559,a7c331a415c8dcae7ce220cbdbe22c053ffd6e52d33ce6154eb591c6f87f02e6,195,681892,a7c331a415c8dcae7ce220cbdbe22c053ffd6e52d33ce6154eb591c6f87f02e6,195,676103,5789,29.69
560,4a9ecbcc0810dc6785568f1819d750f10f2283953bc5a28109495bfc6bab2cd2,195,93711,4a9ecbcc0810dc6785568f1819d750f10f2283953bc5a28109495bfc6bab2cd2,195,90773,2938,15.07
561,7cc1a2c26ac29d93d7cd4e1c081dbc46fac06cf1fe7ad94451260eda0e625003,372,196309,7cc1a2c26ac29d93d7cd4e1c081dbc46fac06cf1fe7ad94451260eda0e625003,372,190875,5434,14.61
562,11bdd49f9cd5ac8b65da9e582cc39cc5b151148e525fab05132edfb8c06373bf,506,160106,11bdd49f9cd5ac8b65da9e582cc39cc5b151148e525fab05132edfb8c06373bf,506,150928,9178,18.14
563,2b72e680d134151584f16eb008907ed7608f7a30a79e88acbaffaa732a292edd,1079,933176,2b72e680d134151584f16eb008907ed7608f7a30a79e88acbaffaa732a292edd,1079,929872,3304,3.06
564,305d1d9d05382824ebbec25dc66a1b3e26c51609d245e7d9ae7a19cc2062b9c0,226,1360119,305d1d9d05382824ebbec25dc66a1b3e26c51609d245e7d9ae7a19cc2062b9c0,226,1356375,3744,16.57
565,38d9d35c1633ce499373b4e0ded6107b6be6cc58ce810e6fc2b3fdd1032c70af,222,53404,38d9d35c1633ce499373b4e0ded6107b6be6cc58ce810e6fc2b3fdd1032c70af,222,50443,2961,13.34
566,66208147117d47002415a4e7a2877a1122a0282078ca29aa0d17b11dd0a73902,195,112072,66208147117d47002415a4e7a2877a1122a0282078ca29aa0d17b11dd0a73902,195,109134,2938,15.07
567,954b58a5076cf617a14e7a86fca8a58ec5ca1384c9f2b048a009e3f58fcfee5f,374,739515,954b58a5076cf617a14e7a86fca8a58ec5ca1384c9f2b048a009e3f58fcfee5f,374,734840,4675,12.5
568,a62629f7d8cffde3e6b78b251b0fa39e9f9f18fb420507a2bbbd12707b758d58,235,475712,a62629f7d8cffde3e6b78b251b0fa39e9f9f18fb420507a2bbbd12707b758d58,235,471708,4004,17.04
569,0238716fe43f3a88edce514c308821a9dd091fb23c2691508f549c715762acde,372,62537777,0238716fe43f3a88edce514c308821a9dd091fb23c2691508f549c715762acde,372,62535348,2429,6.53
570,2f26b5557fa08bf5123b95d4826a0afb2f6d23e7f28e95e4e718229096b32b9d,205,112187,2f26b5557fa08bf5123b95d4826a0afb2f6d23e7f28e95e4e718229096b32b9d,205,108181,4006,19.54
571,b7debb3686f9985afb38920695367a265bb67a4fbab7670782a375557d935f4d,222,98936414,b7debb3686f9985afb38920695367a265bb67a4fbab7670782a375557d935f4d,222,98932743,3671,16.54
572,178ef5812393ad11f9f97ccb377cb9f36be7646c8f5882de8534bacc870ebe76,192,945794,178ef5812393ad11f9f97ccb377cb9f36be7646c8f5882de8534bacc870ebe76,192,943019,2775,14.45
573,54c1df591d5fed96391052413602db0dcafb4e259e770f2befea44c7aa96fbf2,269,15643,54c1df591d5fed96391052413602db0dcafb4e259e770f2befea44c7aa96fbf2,269,11277,4366,16.23
574,a333a8ef4b0e9427f0da692b2bee943e63c9f64e283df08a14e2d449234a4db9,194,78253,a333a8ef4b0e9427f0da692b2bee943e63c9f64e283df08a14e2d449234a4db9,194,75315,2938,15.14
575,b141d0d3a80f845d96048b2a329d1eda0ab4a9a117562bddb73038f6667ac088,506,110093,b141d0d3a80f845d96048b2a329d1eda0ab4a9a117562bddb73038f6667ac088,506,100915,9178,18.14
576,3eff9bc6673058e9030a2063f81236841deac43952271a1905b1a566447b8a87,519,692326,3eff9bc6673058e9030a2063f81236841deac43952271a1905b1a566447b8a87,519,687071,5255,10.13
577,5d1fcd9074ec0355df1c0316d4eed931a365475c656c60a57ff70eee08a13793,4399,37378550,5d1fcd9074ec0355df1c0316d4eed931a365475c656c60a57ff70eee08a13793,4399,37308325,70225,15.96
578,aa07aa40a7cfd6ab713214e9e358f9af3b02c58468740a990e21f2a99829e7b4,351,36709845,aa07aa40a7cfd6ab713214e9e358f9af3b02c58468740a990e21f2a99829e7b4,351,36697016,12829,36.55
579,b34042c3e5f2bb8cb8d432d6766bb5594cca4bbe1d395b4ba5108d7311fb3696,601,8379878,b34042c3e5f2bb8cb8d432d6766bb5594cca4bbe1d395b4ba5108d7311fb3696,601,8364800,15078,25.09
580,c0c042f15643b1f0faf58189336c89baef8c328cdbdf009ef47869fa869929ae,223,97426,c0c042f15643b1f0faf58189336c89baef8c328cdbdf009ef47869fa869929ae,223,93734,3692,16.56
581,4d9b5c1b3da1689bfede500c31360a60b25650ae5b61cff001f7c4393b9960cb,399,2485501,4d9b5c1b3da1689bfede500c31360a60b25650ae5b61cff001f7c4393b9960cb,399,2479640,5861,14.69
582,59d90b19103fb8d00a2307fe62b3bd3e8a0a3daef9d1e0f5d0eafcc8a7c75478,783,516185,59d90b19103fb8d00a2307fe62b3bd3e8a0a3daef9d1e0f5d0eafcc8a7c75478,783,505373,10812,13.81
583,68bf30e7a6796a022b77a1db91a4dcecd88dc2cb4244796d7e137e3539e9096f,224,208889,68bf30e7a6796a022b77a1db91a4dcecd88dc2cb4244796d7e137e3539e9096f,224,206205,2684,11.98
584,8c64300f160309ae93d3b2d9dc6b9361a6d903ad959a37683569a15034752571,191,630163,8c64300f160309ae93d3b2d9dc6b9361a6d903ad959a37683569a15034752571,191,627325,2838,14.86
585,9ce02b337ac10e021ac8a6e649bd5015335bae2b94626715a547ea27889aebce,222,3172500,9ce02b337ac10e021ac8a6e649bd5015335bae2b94626715a547ea27889aebce,222,3168206,4294,19.34
586,b44f6999ad082906e1b5b79998a55cf658e8a910b6c1e5298aea3ee6ce2109bc,246,369515,b44f6999ad082906e1b5b79998a55cf658e8a910b6c1e5298aea3ee6ce2109bc,246,367700,1815,7.38
587,c97812173991f953203cbae299d0f4a9508af0bdbc8eada133004e7e6532d209,193,221860,c97812173991f953203cbae299d0f4a9508af0bdbc8eada133004e7e6532d209,193,219810,2050,10.62
588,0e11a0f4c13a10fcfb0b6f9f58de2076126dad0678522d05acb53869f075b036,191,940000,0e11a0f4c13a10fcfb0b6f9f58de2076126dad0678522d05acb53869f075b036,191,937140,2860,14.97
589,5e1d6592ff6e486363aa7057b5c9c3d47d28c534ca03943c23c69db924740261,154,5000,5e1d6592ff6e486363aa7057b5c9c3d47d28c534ca03943c23c69db924740261,154,4538,462,3
590,8ae8078cd9a7be4141f230be61daf448926fe2a4b1b5a6b4870f7c4b8f24d6df,1072,193311,8ae8078cd9a7be4141f230be61daf448926fe2a4b1b5a6b4870f7c4b8f24d6df,1072,176031,17280,16.12
591,d6380262b6e7bdf6eb0286ab59129f677c205387cb41b59bd7b7a2a381470532,223,7158909,d6380262b6e7bdf6eb0286ab59129f677c205387cb41b59bd7b7a2a381470532,223,7155927,2982,13.37
592,1a5b007d06c922221caea8f8b616b54bc38fcf02dc84d059d3b00606fa18079f,223,334914,1a5b007d06c922221caea8f8b616b54bc38fcf02dc84d059d3b00606fa18079f,223,331222,3692,16.56
593,96d2806e30d9c51f4514fd14254dfb79a5bcd7af88c57f9aae214b8e6ac2670e,154,2500,96d2806e30d9c51f4514fd14254dfb79a5bcd7af88c57f9aae214b8e6ac2670e,154,1884,616,4
594,9777ac3e7771a265a7bd7039a09bac84f6955f4011b0343d17cd081c7d999c16,225,167796,9777ac3e7771a265a7bd7039a09bac84f6955f4011b0343d17cd081c7d999c16,225,164052,3744,16.64
595,9a074a0e0bff4ceba26512c4e1c51c604fd1670beed3bdaa4387fa2dd007822e,254,175867390,9a074a0e0bff4ceba26512c4e1c51c604fd1670beed3bdaa4387fa2dd007822e,254,175852658,14732,58
596,a56cdb3614f3923c83eeeed9940d33b1abda05b521c74eb17b1a07eebd2111e7,205,25898,a56cdb3614f3923c83eeeed9940d33b1abda05b521c74eb17b1a07eebd2111e7,205,21894,4004,19.53
597,36ac4fec585c26cd10811bb888d30629d88d96e5a3fa257be48b9d38438c4ce1,520,6169919,36ac4fec585c26cd10811bb888d30629d88d96e5a3fa257be48b9d38438c4ce1,520,6162782,7137,13.72
598,acdace65619e69aa4a1950305917e153a3747e212883b722e53cfe58d0809b7a,225,198927,acdace65619e69aa4a1950305917e153a3747e212883b722e53cfe58d0809b7a,225,195285,3642,16.19
599,c01fc437ad81e283073946638d46eb6e6c0c387b5c140cd68e9c9826f6ac83a1,225,1243077,c01fc437ad81e283073946638d46eb6e6c0c387b5c140cd68e9c9826f6ac83a1,225,1242097,980,4.36
600,d80e3f72623f7408d3a38bc3f60d495c404a522cda1f9d6c72980fc333848c25,385,52900,d80e3f72623f7408d3a38bc3f60d495c404a522cda1f9d6c72980fc333848c25,385,51986,914,2.37
601,eb3613e4a5691d62fa9fd48fd46386a78c3fc7e2732b944ab09004dfdcef7865,418,34526,eb3613e4a5691d62fa9fd48fd46386a78c3fc7e2732b944ab09004dfdcef7865,418,32744,1782,4.26
602,26f1a6ca631e94ebbc689f86505191e81d12f1b93cf04eb31d8f02d66c6dbe81,223,1005814,26f1a6ca631e94ebbc689f86505191e81d12f1b93cf04eb31d8f02d66c6dbe81,223,1003297,2517,11.29
603,4c82133e8cf347c95cfbe79a343ed0536795b9bd3a8ec02985734d5c1a75a91c,670,10701598,4c82133e8cf347c95cfbe79a343ed0536795b9bd3a8ec02985734d5c1a75a91c,670,10695368,6230,9.3
604,a10173cf263424cdc1d09311d0b275ee96831834485e55d7d8bf4b3b8cdc2116,59294,99364,a10173cf263424cdc1d09311d0b275ee96831834485e55d7d8bf4b3b8cdc2116,59294,10000,89364,1.51
605,a93e89607119ef9d99f1a35a6c091dcca6cd52ed3995a8eadb6215ebf60dd48e,223,300477,a93e89607119ef9d99f1a35a6c091dcca6cd52ed3995a8eadb6215ebf60dd48e,223,296424,4053,18.17
606,d1a9f0861d6be1f82638a6ab3e349e744b4148897f78b74889fbb0909f19cfeb,462,134975,d1a9f0861d6be1f82638a6ab3e349e744b4148897f78b74889fbb0909f19cfeb,462,126860,8115,17.56
607,ddf10bc0eeee258a12deefa7b869f9fee1b81425cd4b821c27cfebddfe22e972,194,193297,ddf10bc0eeee258a12deefa7b869f9fee1b81425cd4b821c27cfebddfe22e972,194,192167,1130,5.82
608,ecc8f61b1a384475b2a9824d640a8631f3c2c55a602e7e622f5dc8ea36385494,234,38974,ecc8f61b1a384475b2a9824d640a8631f3c2c55a602e7e622f5dc8ea36385494,234,36059,2915,12.46
609,ee8904e54f04499153f4bcc81749b340c13d92f4a3d741e9f7bbdc3b3496abd9,214,12625,ee8904e54f04499153f4bcc81749b340c13d92f4a3d741e9f7bbdc3b3496abd9,214,5564,7061,33
610,04936b135284476f0ddc417e083903af410976617a7c09e4afaa6e3e7e91c1ab,405,2376714810,04936b135284476f0ddc417e083903af410976617a7c09e4afaa6e3e7e91c1ab,405,2376709810,5000,12.35
611,19f13d69ec0fd3a0772e290d9b0e2d1d2b85286d145444637faa0c04f3d9e498,248,226353,19f13d69ec0fd3a0772e290d9b0e2d1d2b85286d145444637faa0c04f3d9e498,248,221236,5117,20.63
612,6b5afef3ef1b2ea51121cd7d4adf0e17806a8568b0f7ec5d709acb03098421e3,462,437276,6b5afef3ef1b2ea51121cd7d4adf0e17806a8568b0f7ec5d709acb03098421e3,462,429761,7515,16.27
613,b5c010db8ecf7b28eb769172c18654e0e2e4ff9d0ad13b51ba915eeb8f46bb1b,223,4118981,b5c010db8ecf7b28eb769172c18654e0e2e4ff9d0ad13b51ba915eeb8f46bb1b,223,4115315,3666,16.44
614,e5309703ec8b6ae06446019f04d30ab332e87cc1a787ebf0a0c8aba5d6987de5,222,552719,e5309703ec8b6ae06446019f04d30ab332e87cc1a787ebf0a0c8aba5d6987de5,222,533407,19312,86.99
615,513f2eac2a656578280a13927b1f151602fb54178e8e3e1e403cf6497fd462b3,223,1429100,513f2eac2a656578280a13927b1f151602fb54178e8e3e1e403cf6497fd462b3,223,1423600,5500,24.66
616,68e68e8e249d1e5ba9a0bbd7d4e7d0f43a4fbbbc3cbbaf4744bbdb4c251f3b42,1110,8942180,68e68e8e249d1e5ba9a0bbd7d4e7d0f43a4fbbbc3cbbaf4744bbdb4c251f3b42,1110,8920934,21246,19.14
617,5f9f4f5fe9d5f56aee7171d8531bc4d2ce37acddef24468c277b1e16a69891c6,190,607709,5f9f4f5fe9d5f56aee7171d8531bc4d2ce37acddef24468c277b1e16a69891c6,190,602900,4809,25.31
618,7f711347fd926fbcfb95055efe31cff5db76324287d5135f24a1ec140c74aeaa,226,1249678,7f711347fd926fbcfb95055efe31cff5db76324287d5135f24a1ec140c74aeaa,226,1245934,3744,16.57
619,998e2b1f171fccb3b3a7a80bf4fe00344ccf331631ada8034dc5a9d042b47819,226,1244554,998e2b1f171fccb3b3a7a80bf4fe00344ccf331631ada8034dc5a9d042b47819,226,1236554,8000,35.4
620,b8deb24b01dadf491f6c9d2078a5db7490a64bbf662e923bf7144a3dd56b52ae,223,3168225,b8deb24b01dadf491f6c9d2078a5db7490a64bbf662e923bf7144a3dd56b52ae,223,3162427,5798,26
621,390c074cceb0e81606a6615649969204c7bd58ef11f2d6c78de0fe518473d2a7,222,3234266,390c074cceb0e81606a6615649969204c7bd58ef11f2d6c78de0fe518473d2a7,222,3231305,2961,13.34
622,808727f4f7880051f11d7bfa39d28ab67fa7e2077aa998d57f9ab53245393ea5,372,881966,808727f4f7880051f11d7bfa39d28ab67fa7e2077aa998d57f9ab53245393ea5,372,876506,5460,14.68
623,a10a5b51c1bfeb0cef13fab7383c21235e48ae3246f8f711e50f3aebf86c4b9b,225,14583092,a10a5b51c1bfeb0cef13fab7383c21235e48ae3246f8f711e50f3aebf86c4b9b,225,14579903,3189,14.17
624,01379ddc34921036c5de0fabfe388d7bad6c80995a9e75dee0a095bac5335831,235,15000,01379ddc34921036c5de0fabfe388d7bad6c80995a9e75dee0a095bac5335831,235,11000,4000,17.02
625,1049048f3e5681b86856eecd33814f8b0493eac2ef51bb87976750def47b2157,222,150725,1049048f3e5681b86856eecd33814f8b0493eac2ef51bb87976750def47b2157,222,146672,4053,18.26
626,28b0d2bd12e1a3b97ee4c20cabc92bd6931e515d629d85a367c29582e76565de,393,4781770,28b0d2bd12e1a3b97ee4c20cabc92bd6931e515d629d85a367c29582e76565de,393,4780164,1606,4.09
627,33960e43913d0ded0aeac59e85dd0914bf5375aa07d03b787915a9c9d582f9d0,444,1000000,33960e43913d0ded0aeac59e85dd0914bf5375aa07d03b787915a9c9d582f9d0,444,997293,2707,6.1
628,d2584e4045193f9295c29bcda3102e43147185bd07352dc947dcdc2369966a6f,223,70626,d2584e4045193f9295c29bcda3102e43147185bd07352dc947dcdc2369966a6f,223,66818,3808,17.08
629,df90826c5d98f29e8643ae9b18abbba73497796f62bd4663001fface9713d8b4,836,3598781,df90826c5d98f29e8643ae9b18abbba73497796f62bd4663001fface9713d8b4,836,3585986,12795,15.31
630,40c93ff1eec6aefa217125192ef570f230d010faa73957138df0d31beb6f58a4,154,2500,40c93ff1eec6aefa217125192ef570f230d010faa73957138df0d31beb6f58a4,154,1884,616,4
631,80fe785cd2c6b89bf9d8fdc0cbf29cd253962b0d20280134443f73b5ba22f00e,223,4740100,80fe785cd2c6b89bf9d8fdc0cbf29cd253962b0d20280134443f73b5ba22f00e,223,4734500,5600,25.11
632,85dd95a770e7a6d7b86d350b62a30bbd0af9b7541bd567293594215f4f2719c4,222,732551911,85dd95a770e7a6d7b86d350b62a30bbd0af9b7541bd567293594215f4f2719c4,222,732550501,1410,6.35
633,e9acb83af1ed25b4d89c52d02c51d215f4eeb9af89cdbd382f38c09a86da5430,223,101329690,e9acb83af1ed25b4d89c52d02c51d215f4eeb9af89cdbd382f38c09a86da5430,223,101326024,3666,16.44
634,ec4ae06659dab93c057aa3753bb78c1692097c68fcb427936693701c9e064467,224,710324,ec4ae06659dab93c057aa3753bb78c1692097c68fcb427936693701c9e064467,224,706632,3692,16.48
635,f8c0d46361b0d5e280c35f42e11e7679f307c6ff77ad5c14d23273702b39d04f,387,219141412,f8c0d46361b0d5e280c35f42e11e7679f307c6ff77ad5c14d23273702b39d04f,387,219135940,5472,14.14
636,34fefd0414961c8dab4a34f1aed68b65b34ab5f2871f05d621f0d3c2208f800e,462,245210,34fefd0414961c8dab4a34f1aed68b65b34ab5f2871f05d621f0d3c2208f800e,462,237095,8115,17.56
637,7c3306b7f3b7e46ae29492d4635d3b2cee55c8f7559f3c60044a043f3ebe821c,371,339801,7c3306b7f3b7e46ae29492d4635d3b2cee55c8f7559f3c60044a043f3ebe821c,371,338564,1237,3.33
638,7c75d1b292661c8f58db959babab2b097d7df43740026483159725a8c036bd17,223,75986,7c75d1b292661c8f58db959babab2b097d7df43740026483159725a8c036bd17,223,70706,5280,23.68
639,d2c4f7acdf77e23622731863026dff3a7543a9bab7d6ee96555302f304e01ab5,370,94735,d2c4f7acdf77e23622731863026dff3a7543a9bab7d6ee96555302f304e01ab5,370,89301,5434,14.69
640,2bee06d3eb17cfeb0ab0d3c304a78ced1db88f1b3c3b6e05d2e27100276f8f7a,192,1144650,2bee06d3eb17cfeb0ab0d3c304a78ced1db88f1b3c3b6e05d2e27100276f8f7a,192,1143642,1008,5.25
641,4479b40570313c6250acfd127d30663d99b2e448a2e551e55d07dbdea120e8f8,225,1242529,4479b40570313c6250acfd127d30663d99b2e448a2e551e55d07dbdea120e8f8,225,1238785,3744,16.64
642,4a25a282db22b087a61a04e56cd5cbf6460e64540418a934580c45eeb81dac54,407,3934,4a25a282db22b087a61a04e56cd5cbf6460e64540418a934580c45eeb81dac54,407,2500,1434,3.52
643,4e6ed5a3ca093f485099b9a9c67b14f4fb2e10d1300328b242f3ad7e6b83387d,7025,432925577,4e6ed5a3ca093f485099b9a9c67b14f4fb2e10d1300328b242f3ad7e6b83387d,7025,432867789,57788,8.23
644,589fecaa9c4205ac677ab0235a2b1f21a8b63ca65726b66e43a7e306eb8f09b0,194,77711,589fecaa9c4205ac677ab0235a2b1f21a8b63ca65726b66e43a7e306eb8f09b0,194,74773,2938,15.14
645,8fd2017ecd3847f41c9b549c9bed9e9f5303331fbf3bfbe4fd933d9dc50fa953,223,438037,8fd2017ecd3847f41c9b549c9bed9e9f5303331fbf3bfbe4fd933d9dc50fa953,223,434487,3550,15.92
646,9d700c89a727fd675a273664bf940f9c0b3e82de6e5a047e61496fd5c6e777f8,5598,3764240,9d700c89a727fd675a273664bf940f9c0b3e82de6e5a047e61496fd5c6e777f8,5598,3747032,17208,3.07
647,e2f3bc0b18a25787610c92247d7a45e3213cdb789352845316ed12df86d25156,248,505182,e2f3bc0b18a25787610c92247d7a45e3213cdb789352845316ed12df86d25156,248,480143,25039,100.96
648,5f68c2b13d98c35f9fa06ee7322e68c2a9773f1d5e9885f0c9ca89fa286e7aef,256,737521,5f68c2b13d98c35f9fa06ee7322e68c2a9773f1d5e9885f0c9ca89fa286e7aef,256,733003,4518,17.65
649,7759ab687c577864e16bb0e91062582ea6b9c019102d31c43f0cfed59843cb39,339,504000,7759ab687c577864e16bb0e91062582ea6b9c019102d31c43f0cfed59843cb39,339,500808,3192,9.42
650,c07a783a9faea5ea62ef670cceb3f2b29100c195751b346564da7b4a0511d532,419,451814,c07a783a9faea5ea62ef670cceb3f2b29100c195751b346564da7b4a0511d532,419,445510,6304,15.05
651,c305d000d631c671ecbf52b68bb2bef16cf0549e19b588acc7a24bc0b6116ae3,406,6434,c305d000d631c671ecbf52b68bb2bef16cf0549e19b588acc7a24bc0b6116ae3,406,5000,1434,3.53
652,09eb2cd24206a91e536478114d706c9893449d9f3be45ac70c3ad0040aea7a14,666,888444,09eb2cd24206a91e536478114d706c9893449d9f3be45ac70c3ad0040aea7a14,666,872169,16275,24.44
653,1d2451ae12ec06bc2646aa0c3334aa762931d2dce20e1b1e9e4b6c94ae43194e,506,100114,1d2451ae12ec06bc2646aa0c3334aa762931d2dce20e1b1e9e4b6c94ae43194e,506,90936,9178,18.14
654,2ff3a69eccdfda2477d5214ed13c3da14f4174c246318bcac66cd7599d788f93,191,1003364,2ff3a69eccdfda2477d5214ed13c3da14f4174c246318bcac66cd7599d788f93,191,1000680,2684,14.05
655,522ee40c411190d4c1795973648d6bafd1defbe53cd731cb04e787e446774d42,519,90112,522ee40c411190d4c1795973648d6bafd1defbe53cd731cb04e787e446774d42,519,84857,5255,10.13
656,78eb458973af6ced1067f4490a81c6e42139bf895bd3a22117147e66f757d0cd,435,2684991,78eb458973af6ced1067f4490a81c6e42139bf895bd3a22117147e66f757d0cd,435,2677943,7048,16.2
657,034c8fac970cc32b4d80907932ef5796a29069da910faa54d480d912f6d42685,195,913995,034c8fac970cc32b4d80907932ef5796a29069da910faa54d480d912f6d42685,195,911057,2938,15.07
658,61f3c7230503b751b2ef5493d11ca947f87bf5d9ff890d84395da54bf29a6dbf,255,218884283,61f3c7230503b751b2ef5493d11ca947f87bf5d9ff890d84395da54bf29a6dbf,255,218881331,2952,11.58
659,67283f466a2de359f1265fe1c9e8024e9872d21e735c1afae07865babd083690,518,374134,67283f466a2de359f1265fe1c9e8024e9872d21e735c1afae07865babd083690,518,358996,15138,29.22
660,69ad1f8d7106cf779bfacc5d0afe9a339cb0ede7d043d8fb84e2baa819abc17f,387,119376,69ad1f8d7106cf779bfacc5d0afe9a339cb0ede7d043d8fb84e2baa819abc17f,387,112601,6775,17.51
661,8c9a6c0f037a373e123de1739fb04b4d9cedcc0af1633cbf8904ee13845388ba,224,332274,8c9a6c0f037a373e123de1739fb04b4d9cedcc0af1633cbf8904ee13845388ba,224,328582,3692,16.48
662,9a0ae6123b55c6daa808d9f648726ac738ec1f26961184b4cacc3428ab5c13c3,303,32860,9a0ae6123b55c6daa808d9f648726ac738ec1f26961184b4cacc3428ab5c13c3,303,30451,2409,7.95
663,b11022693ad39d13d68a816d13441589215afec17fc22d9139fd0d4e97294703,341,24671,b11022693ad39d13d68a816d13441589215afec17fc22d9139fd0d4e97294703,341,17607,7064,20.72
664,daa072f45cca5d699fcb7996d023ab82f1b2f87e3450ef26530db15d1435c0aa,192,60415,daa072f45cca5d699fcb7996d023ab82f1b2f87e3450ef26530db15d1435c0aa,192,59645,770,4.01
665,437ebe3b03574f0497944a284a702b16c9d83d2809e293595cbf6932a469345a,225,812875,437ebe3b03574f0497944a284a702b16c9d83d2809e293595cbf6932a469345a,225,808792,4083,18.15
666,6c78b0e4fee30fa03e4e61f8f3622670f42c1ab0c47eb9104a91482aafa48ea9,203,999096,6c78b0e4fee30fa03e4e61f8f3622670f42c1ab0c47eb9104a91482aafa48ea9,203,998122,974,4.8
667,b5e8c2693e5ad2aa4cc4ad787a1052d5b8203c90b1ac4b44b5288ce1628ed82c,193,101158,b5e8c2693e5ad2aa4cc4ad787a1052d5b8203c90b1ac4b44b5288ce1628ed82c,193,98470,2688,13.93
668,ea490e1add6bfc4a46e54b50459475aee541e7de28ec0fedd0e5c067f2ca120c,223,139142,ea490e1add6bfc4a46e54b50459475aee541e7de28ec0fedd0e5c067f2ca120c,223,138163,979,4.39
669,ef071fe14cdf405d1cde163c96049a468223d3a67f1240c1e46fe8e2b311b3c6,151,2500,ef071fe14cdf405d1cde163c96049a468223d3a67f1240c1e46fe8e2b311b3c6,151,1896,604,4
670,2fc983aefa3041b5676a0905803cf51d8fb917c16a95fdf52755c9d1bf7cfa69,373,965625,2fc983aefa3041b5676a0905803cf51d8fb917c16a95fdf52755c9d1bf7cfa69,373,962063,3562,9.55
671,4705a01ddd28cb0d1ae5b2ede7178930dbe4f978aabc38f5f5d0f8ce5c337187,191,162722,4705a01ddd28cb0d1ae5b2ede7178930dbe4f978aabc38f5f5d0f8ce5c337187,191,159862,2860,14.97
672,501d281b35b64f92a7c2fb25de47ba22e5fc32b41c6865d6f012b3e47b5b4274,383,862664917,501d281b35b64f92a7c2fb25de47ba22e5fc32b41c6865d6f012b3e47b5b4274,383,862618405,46512,121.44
673,591fb7fd53d5aca68ce0fa0c13ff7b5a5c99e91fd8ffdebae03e0235734fe8c7,225,12812268,591fb7fd53d5aca68ce0fa0c13ff7b5a5c99e91fd8ffdebae03e0235734fe8c7,225,12811386,882,3.92
674,6820c9cd3bb20dcce5d55100f70be5c0dc70a30e280f00abeaf63a4a3f37aa63,223,31403386,6820c9cd3bb20dcce5d55100f70be5c0dc70a30e280f00abeaf63a4a3f37aa63,223,31397280,6106,27.38
675,e3de4b112dff8a2fbd9a9113d32d58e2cb41e79614f11959c0e212549e3c5c8c,534,8332590,e3de4b112dff8a2fbd9a9113d32d58e2cb41e79614f11959c0e212549e3c5c8c,534,8304990,27600,51.69
676,65e260cb94062df10be7aa7330fbe27d667a950b7d0e0e294fb9630d8ec6302c,194,10956112,65e260cb94062df10be7aa7330fbe27d667a950b7d0e0e294fb9630d8ec6302c,194,10952368,3744,19.3
677,76d4e9a934b23a6e7483c8bfe7cc721349e732d2e6f6616486a0d38c06a9a9f9,868,5922592,76d4e9a934b23a6e7483c8bfe7cc721349e732d2e6f6616486a0d38c06a9a9f9,868,5905816,16776,19.33
678,9e03b7b5a1b60366676c6c80083629847d4c9b2cb4ed4c8f1830750923318260,195,335907,9e03b7b5a1b60366676c6c80083629847d4c9b2cb4ed4c8f1830750923318260,195,332969,2938,15.07
679,b9ffb34a7f43c369fcb8d8cd93cb5f090767951b9e1e26197a632afa75f0d24f,372,122138,b9ffb34a7f43c369fcb8d8cd93cb5f090767951b9e1e26197a632afa75f0d24f,372,120854,1284,3.45
680,cc1a8c90e9ca0681b22eec635b2a908abb04ceed40b00fc37d2a9d694cb17670,205,701132,cc1a8c90e9ca0681b22eec635b2a908abb04ceed40b00fc37d2a9d694cb17670,205,700208,924,4.51
681,f8f46bae02f0084760089010b190c10a58a5fff5753ed8b2e99260fa2d00178e,977,133867097,f8f46bae02f0084760089010b190c10a58a5fff5753ed8b2e99260fa2d00178e,977,133839321,27776,28.43
682,01272b8f1becc2dc98290e313ce1d34bf7264da9af0fe1e30b86952d25b019e1,533,8155590,01272b8f1becc2dc98290e313ce1d34bf7264da9af0fe1e30b86952d25b019e1,533,8127990,27600,51.78
683,2c9e8e663ef22ca553399ce708bb5f814dca86962d9e4c7cdacce7b14a29fa0b,20405,560211444,2c9e8e663ef22ca553399ce708bb5f814dca86962d9e4c7cdacce7b14a29fa0b,20405,560121753,89691,4.4
684,7aa9824df171257570f0d18e17f35226c29d4980f4ca2d24de649cc6389475b4,222,1443174,7aa9824df171257570f0d18e17f35226c29d4980f4ca2d24de649cc6389475b4,222,1442255,919,4.14
685,fbd7c93bc1d7e6c8790fb108c60ee0d606eb22f0961e99684036a0af19ee6277,359,7000,fbd7c93bc1d7e6c8790fb108c60ee0d606eb22f0961e99684036a0af19ee6277,359,5344,1656,4.61
686,3b42a90001c05a2acf31986b342dc11d548fff9e05372f8f8d456a898cd4cb8e,163,105644,3b42a90001c05a2acf31986b342dc11d548fff9e05372f8f8d456a898cd4cb8e,163,104990,654,4.01
687,6ddab1a83d1184c12c5eaab118407d871bed67ed2e0e403c583a05b9be64e571,192,1656280,6ddab1a83d1184c12c5eaab118407d871bed67ed2e0e403c583a05b9be64e571,192,1654917,1363,7.1
688,eb9519c990b2a6fce66054e456a3a970a14700cf5f9c77d434348cc51b18d462,729,4290012,eb9519c990b2a6fce66054e456a3a970a14700cf5f9c77d434348cc51b18d462,729,4277475,12537,17.2
689,2309e75e8ba6bd9b086d0f3a79955a09ef3ca0005006cad878fb91fe303f7b0d,405,6434,2309e75e8ba6bd9b086d0f3a79955a09ef3ca0005006cad878fb91fe303f7b0d,405,5000,1434,3.54
690,48f39e0ceb2db0985c3f26c3447d08693847d5dc8f11b58a301833908cc24924,406,6432,48f39e0ceb2db0985c3f26c3447d08693847d5dc8f11b58a301833908cc24924,406,5000,1432,3.53
691,58bd431526c9151de193d7e02409dadaf0bd123b9b1ab2c764ec8f1e15a67c54,245,3184137,58bd431526c9151de193d7e02409dadaf0bd123b9b1ab2c764ec8f1e15a67c54,245,3180129,4008,16.36
692,6833f90a84d706cacfea39bc0fd1c1689ee8a99cb62e2767dfeb500c3a7850f1,225,148300,6833f90a84d706cacfea39bc0fd1c1689ee8a99cb62e2767dfeb500c3a7850f1,225,145420,2880,12.8
693,04bc524a5b33741a1500a0de70d131e6614df5a43c8ebcc0ed6a479754aa113c,491,1793077,04bc524a5b33741a1500a0de70d131e6614df5a43c8ebcc0ed6a479754aa113c,491,1786603,6474,13.19
694,128d6a0813b00f9ab08d8e2703209f6368f87416e795123156ad3c9bbfcd8f23,223,1004307,128d6a0813b00f9ab08d8e2703209f6368f87416e795123156ad3c9bbfcd8f23,223,1000800,3507,15.73
695,187de48be4fdfba00b4450211fa9dae10446cb6f3f9cbe146e5edcfbfa148bb9,223,125617902,187de48be4fdfba00b4450211fa9dae10446cb6f3f9cbe146e5edcfbfa148bb9,223,125617022,880,3.95
696,4bcbc27ed079bea760d19749b662aa54902c2da62ab388d36361559dd071a3c6,195,138679,4bcbc27ed079bea760d19749b662aa54902c2da62ab388d36361559dd071a3c6,195,137851,828,4.25
697,4eaf355fad49f3441571c7fe6ff601c639d5b94a4aeaaa023e1e024bf11ee168,248,52821,4eaf355fad49f3441571c7fe6ff601c639d5b94a4aeaaa023e1e024bf11ee168,248,51332,1489,6
698,5aafc540c191826a21a9eaeac567e085d6176a2526f8ed759a7cf7bd84534859,224,782915,5aafc540c191826a21a9eaeac567e085d6176a2526f8ed759a7cf7bd84534859,224,779223,3692,16.48
699,750c335552cfe483550cc957eac2b69350640eebe1d83a262dcc798df62f55d1,192,4981150,750c335552cfe483550cc957eac2b69350640eebe1d83a262dcc798df62f55d1,192,4977431,3719,19.37
700,d45b84a714aa4433c649ef239e20afb8771b1c48f373d9c79c4cbf5073305d53,312,36871,d45b84a714aa4433c649ef239e20afb8771b1c48f373d9c79c4cbf5073305d53,312,33055,3816,12.23
701,2d3c16acdb637821ace3ba00f5da60542e9438ffb5ca2c939930adedb4f172a6,223,3457449,2d3c16acdb637821ace3ba00f5da60542e9438ffb5ca2c939930adedb4f172a6,223,3453757,3692,16.56
702,64a7448e4d4e24064c38b216f9cd45b6b7169b7da06de82c4c331117cd87a83a,192,105620,64a7448e4d4e24064c38b216f9cd45b6b7169b7da06de82c4c331117cd87a83a,192,103442,2178,11.34
703,6c4b3af7ab56ecc15f57478f312f1f385899fc4f1480db1100558914d64388c5,482,1059345,6c4b3af7ab56ecc15f57478f312f1f385899fc4f1480db1100558914d64388c5,482,1056412,2933,6.09
704,7103928854d4f1c7aa9f2594ef60674c4d65805140853df0588a26593c19517a,223,772628,7103928854d4f1c7aa9f2594ef60674c4d65805140853df0588a26593c19517a,223,769944,2684,12.04
705,aec89be24e4af58c2557bff3971fa699324d165bd935c223007306b7330df3c0,223,163706,aec89be24e4af58c2557bff3971fa699324d165bd935c223007306b7330df3c0,223,157882,5824,26.12
706,b9232bc6267fd476ffdb660d563d810eb75000321024b09df79548b4931b606e,223,3991114,b9232bc6267fd476ffdb660d563d810eb75000321024b09df79548b4931b606e,223,3987708,3406,15.27
707,d8d0d4c5bc9774de4f0f760f017a401e2e0f9ac3230b2adc6353f1ad5223bf59,515,4898870,d8d0d4c5bc9774de4f0f760f017a401e2e0f9ac3230b2adc6353f1ad5223bf59,515,4893720,5150,10
708,1b0185149b274a958e0b63a732e3e8d8328e7e1838aea81d1feecd3eccf3b7de,194,164192,1b0185149b274a958e0b63a732e3e8d8328e7e1838aea81d1feecd3eccf3b7de,194,161254,2938,15.14
709,2babb5ac5c26390513c1ca272a5f7820df740e771f678e05f041007d6d539025,223,3042575,2babb5ac5c26390513c1ca272a5f7820df740e771f678e05f041007d6d539025,223,3041596,979,4.39
710,2c9820f8e324991ac360e1810b6183adb9578e9e0165bec0c97bf4e6aef453de,191,25983,2c9820f8e324991ac360e1810b6183adb9578e9e0165bec0c97bf4e6aef453de,191,24401,1582,8.28
711,5bcf765c0859f0f838eed26e8be7025b517a97ac35ef1d71805eec747c74eebe,191,215350,5bcf765c0859f0f838eed26e8be7025b517a97ac35ef1d71805eec747c74eebe,191,206373,8977,47
712,f2f00d71e35f81fd5248c374e3089a3df08b339275d93fec52e4dcf3f7a8b0d5,223,303925,f2f00d71e35f81fd5248c374e3089a3df08b339275d93fec52e4dcf3f7a8b0d5,223,300259,3666,16.44
713,013a01825179c2a52a284d1e9c960994eb23343f9957fb57a7327c770aa2bbe5,215,58156,013a01825179c2a52a284d1e9c960994eb23343f9957fb57a7327c770aa2bbe5,215,56400,1756,8.17
714,2989fcd17c145712e368f6460663185ffc3f6cdc2dc9c87b6ad4627d1a276a49,370,1363770,2989fcd17c145712e368f6460663185ffc3f6cdc2dc9c87b6ad4627d1a276a49,370,1358670,5100,13.78
715,9564023c1a469d99318db636cea7be3461ed1999742e7db33e77a049a1aff7d9,247,30473335,9564023c1a469d99318db636cea7be3461ed1999742e7db33e77a049a1aff7d9,247,30469214,4121,16.68
716,b885139a02795586408e3e9da82526ad3e37a89eac25a25067ee9f8356bf9c3b,533,8367990,b885139a02795586408e3e9da82526ad3e37a89eac25a25067ee9f8356bf9c3b,533,8340390,27600,51.78
717,07e95b5ded6f5ae1f7530d47e09c2bda00ce5a45eaf47223b9dd12cc9b933cd5,662,59393683884,07e95b5ded6f5ae1f7530d47e09c2bda00ce5a45eaf47223b9dd12cc9b933cd5,662,59393668908,14976,22.62
718,5c404c118eb934ae98e684801933c0e47eecc1dbd1a9213ca36ce011459bfcd1,266,1205452,5c404c118eb934ae98e684801933c0e47eecc1dbd1a9213ca36ce011459bfcd1,266,1198297,7155,26.9
719,602804648e5c6604e164048a719213cf4cbb49677a3df0e39150044d46b90ce1,226,570160,602804648e5c6604e164048a719213cf4cbb49677a3df0e39150044d46b90ce1,226,566919,3241,14.34
720,a97dd7246cce12bf11d0fa796450f499dcdaefe867cd2b2391102bbb56782d2c,192,844283,a97dd7246cce12bf11d0fa796450f499dcdaefe867cd2b2391102bbb56782d2c,192,842105,2178,11.34
721,d2e6048a56a93ab974bdaa5d410a141ba71e5e7a7294ad526efe5f36dbca3806,191,4544,d2e6048a56a93ab974bdaa5d410a141ba71e5e7a7294ad526efe5f36dbca3806,191,3523,1021,5.35
722,fc19378cc8325635f39981882108228de3f0d9f91721c85ad4cd2be2cc24a4b0,312,365424,fc19378cc8325635f39981882108228de3f0d9f91721c85ad4cd2be2cc24a4b0,312,364152,1272,4.08
723,5932d6de87afd895142f89eca80e06c5ac11e33bc586b013b7bd084863279b25,223,411915,5932d6de87afd895142f89eca80e06c5ac11e33bc586b013b7bd084863279b25,223,408223,3692,16.56
724,5d749321d11de8f14ca8470ec9204e05e17e1a03226cf40ed292cc8421d367bf,192,179665,5d749321d11de8f14ca8470ec9204e05e17e1a03226cf40ed292cc8421d367bf,192,176100,3565,18.57
725,6f6094c14bfddf37f9091028e8730261f3ee6ad7b82ae09cb58bfaa49774c0a5,154,5000,6f6094c14bfddf37f9091028e8730261f3ee6ad7b82ae09cb58bfaa49774c0a5,154,3768,1232,8
726,9de90f18af1abbe5d8e158cc2e457705d181996480c05e0ca9a97e474146bb20,191,616439,9de90f18af1abbe5d8e158cc2e457705d181996480c05e0ca9a97e474146bb20,191,613236,3203,16.77
727,af289e7e1a407c4192e1b0ec4d001fd71c94697b8a9702be4887d64c2a29fbed,226,18463170,af289e7e1a407c4192e1b0ec4d001fd71c94697b8a9702be4887d64c2a29fbed,226,18459241,3929,17.38
728,02b33135617ca7cb49fbd7dcf082ae88182de510bca596c0b1ab0adeee9e397a,194,1116880,02b33135617ca7cb49fbd7dcf082ae88182de510bca596c0b1ab0adeee9e397a,194,1113942,2938,15.14
729,1d9679431d49cae099ca77018c78d5a565cb7afeed5c6e9c42d39ffc1908b81e,321,816713127,1d9679431d49cae099ca77018c78d5a565cb7afeed5c6e9c42d39ffc1908b81e,321,816706931,6196,19.3
730,290520932a17b58bd4fdae202e915b85cdda0fa4ea17efd02db6adb415d0d813,284,2447876,290520932a17b58bd4fdae202e915b85cdda0fa4ea17efd02db6adb415d0d813,284,2442801,5075,17.87
731,3dec268bb7a4b637de2a75537eae50a1fa5abb546e97b74da95b79d4be6aebc5,222,59078896,3dec268bb7a4b637de2a75537eae50a1fa5abb546e97b74da95b79d4be6aebc5,222,59077345,1551,6.99
732,692d15bc6a167f569be70d6f0652c69af2ab61ca89db296ef551245e951ca555,154,5000,692d15bc6a167f569be70d6f0652c69af2ab61ca89db296ef551245e951ca555,154,4384,616,4
733,83fb44e9a0933d652874b57572dfa032cd8436ceac5bab2389dae3e730722ed6,786,432507,83fb44e9a0933d652874b57572dfa032cd8436ceac5bab2389dae3e730722ed6,786,430327,2180,2.77
734,3e2a0a9b4aa1f51db8dc1aa25396fe3828b02741c6f4bfe26889f3ef810376fd,195,170717,3e2a0a9b4aa1f51db8dc1aa25396fe3828b02741c6f4bfe26889f3ef810376fd,195,166874,3843,19.71
735,4b620874335862cd9c39c53ccc36507bb76f139bede92c6df57738a9cf3ee742,934,986567,4b620874335862cd9c39c53ccc36507bb76f139bede92c6df57738a9cf3ee742,934,982959,3608,3.86
736,d4f9a6d43b9e9a278189a67d9bff623a95585ce6290252a25fa6a208f7257564,194,1514303,d4f9a6d43b9e9a278189a67d9bff623a95585ce6290252a25fa6a208f7257564,194,1511741,2562,13.21
737,0f264a22100caef269f98af0db16be0977894ea42dfc9c040d7fc9324bbb3754,1351,1500000000,0f264a22100caef269f98af0db16be0977894ea42dfc9c040d7fc9324bbb3754,1351,1499976721,23279,17.23
738,50bbd5c858f6d7c8fecc26cae347ff7907e51704cd1f24bf0b62f2b27c6f8031,1559,8951565,50bbd5c858f6d7c8fecc26cae347ff7907e51704cd1f24bf0b62f2b27c6f8031,1559,8946318,5247,3.37
739,61f59efb73bdfc73d5ffbeff11a785303121ceca62e41526ed24d45ef3466f4c,253,1738855,61f59efb73bdfc73d5ffbeff11a785303121ceca62e41526ed24d45ef3466f4c,253,1736775,2080,8.22
740,a99f8ce5bda26d7f571f5b4327709df59a77ca500b112b72de9a34222fcc605e,223,20483594,a99f8ce5bda26d7f571f5b4327709df59a77ca500b112b72de9a34222fcc605e,223,20479953,3641,16.33
741,b98da904573f93638ca0173464178d117d611fc9ed7b32d55e4365b78510646f,2736,177302254,b98da904573f93638ca0173464178d117d611fc9ed7b32d55e4365b78510646f,2736,177291501,10753,3.93
742,fab61401fad1735101834cccc47ee03c056772f1bd0452fc3fbcbdbf8829ef00,249,871255,fab61401fad1735101834cccc47ee03c056772f1bd0452fc3fbcbdbf8829ef00,249,870247,1008,4.05
743,01e27a692809cd62f93bec28ceed2df83425989a7a8b4552b825e1559fb9fcac,192,1761580,01e27a692809cd62f93bec28ceed2df83425989a7a8b4552b825e1559fb9fcac,192,1757865,3715,19.35
744,2fa899fd5f6c3c8df267b55c7ed894faf64d1017689d22c84fc95d685d640824,225,290413,2fa899fd5f6c3c8df267b55c7ed894faf64d1017689d22c84fc95d685d640824,225,284989,5424,24.11
745,f4f84905a1975fa67db2d94ffe0fb20d134358246a4930ec62aff6769a284767,372,3823240,f4f84905a1975fa67db2d94ffe0fb20d134358246a4930ec62aff6769a284767,372,3818121,5119,13.76
746,0a5b89bcef74c6a1a56093135cc224424d90a3f6151c4d54b628ff21905552a7,223,28601,0a5b89bcef74c6a1a56093135cc224424d90a3f6151c4d54b628ff21905552a7,223,27615,986,4.42
747,32a19c65b74fef80aa3f4ec472add5bdfadbea2aa4a2b42e5b81abd2d2f778e2,222,431700,32a19c65b74fef80aa3f4ec472add5bdfadbea2aa4a2b42e5b81abd2d2f778e2,222,426240,5460,24.59
748,7a1e2f276c212a23a528a22dfb3714bb26498c8f9818a6c5ac5bc304a54482cd,222,608000,7a1e2f276c212a23a528a22dfb3714bb26498c8f9818a6c5ac5bc304a54482cd,222,604359,3641,16.4
749,a81c97a1b1247742cdb4710bf4677f05cfa4d0363516038ffb4542b2c4402929,225,79816789,a81c97a1b1247742cdb4710bf4677f05cfa4d0363516038ffb4542b2c4402929,225,79794298,22491,99.96
750,bb40093223cdd599e23800c4b57011e68040ed48a8502ad58a622d9660c34f84,293,33659602,bb40093223cdd599e23800c4b57011e68040ed48a8502ad58a622d9660c34f84,293,33642642,16960,57.88
751,05e1f117740c9ddde18fc1cf5fe756f66cb6fd0f6d276c3af652979e1e4271d5,236,972042,05e1f117740c9ddde18fc1cf5fe756f66cb6fd0f6d276c3af652979e1e4271d5,236,971197,845,3.58
752,7fcbe5df94c40af459674a4a8a1fd1c7cf3ad146658085b32f784112d15e4789,224,1288902,7fcbe5df94c40af459674a4a8a1fd1c7cf3ad146658085b32f784112d15e4789,224,1283835,5067,22.62
753,88f3a3ba81a3868f9d5426d6c13794099b288ea5b558f3e7e1b1dbb701753913,223,20232,88f3a3ba81a3868f9d5426d6c13794099b288ea5b558f3e7e1b1dbb701753913,223,19246,986,4.42
754,f100e6cdc1387964cd176777ac5e99193b4cd557bbca9d68afcc197d360c1023,450,457253,f100e6cdc1387964cd176777ac5e99193b4cd557bbca9d68afcc197d360c1023,450,449609,7644,16.99
755,852f0c33f9ee1de3df1e974258e6658e42fc67123ca721149f30737863ffbdd0,226,513423,852f0c33f9ee1de3df1e974258e6658e42fc67123ca721149f30737863ffbdd0,226,509283,4140,18.32
756,8c9f9c3054d2a6a700163f5292f1dc608512d31feb67e6b224c4ffdf789b9e2f,223,374112,8c9f9c3054d2a6a700163f5292f1dc608512d31feb67e6b224c4ffdf789b9e2f,223,370420,3692,16.56
757,9b216f8c01d670f827af0bdc7bbe62e80b8264c5cb8746d4bedae261f2bf4b30,223,6898722,9b216f8c01d670f827af0bdc7bbe62e80b8264c5cb8746d4bedae261f2bf4b30,223,6897743,979,4.39
758,cc130c84b82e81dca83f6ed04b2c951dc7661d8e6c078c65242ed0f2bbdfbe09,192,354026,cc130c84b82e81dca83f6ed04b2c951dc7661d8e6c078c65242ed0f2bbdfbe09,192,350054,3972,20.69
759,d881eea5b9433911c438b5b281604d148c7869f2349cdcab97cc52de7d29d24f,228,707411,d881eea5b9433911c438b5b281604d148c7869f2349cdcab97cc52de7d29d24f,228,705206,2205,9.67
760,0fceb772bab139ae135c311f7164d8838ea228cdaa4d13d31a2c3fe827c9dcc2,408,1080341,0fceb772bab139ae135c311f7164d8838ea228cdaa4d13d31a2c3fe827c9dcc2,408,1073607,6734,16.5
761,13ee35a91c3f24a0fe6c8b9965ecf517bf40b505330e8cc2cf940e13217d86da,419,45117086,13ee35a91c3f24a0fe6c8b9965ecf517bf40b505330e8cc2cf940e13217d86da,419,45110255,6831,16.3
762,2a5c00054abd62ad3bdefd91a5b3d764fad357a38c3155f74c64d4366533b2ab,226,844102,2a5c00054abd62ad3bdefd91a5b3d764fad357a38c3155f74c64d4366533b2ab,226,840358,3744,16.57
763,36cbee8fd09b24865a442462c4b5c1e4d2556eb2aaa8500f97387b125534ab81,520,15091279,36cbee8fd09b24865a442462c4b5c1e4d2556eb2aaa8500f97387b125534ab81,520,15084142,7137,13.72
764,43246562d4608d30dfac320cbffaabb748ef9108151cfc73ccbca42fcf058c84,12451,9496384,43246562d4608d30dfac320cbffaabb748ef9108151cfc73ccbca42fcf058c84,12451,9463374,33010,2.65
765,48b0de52c1f597dfb86a30d680d1966f593f484b4a0e5f0d4ec120a710882245,416,322738712,48b0de52c1f597dfb86a30d680d1966f593f484b4a0e5f0d4ec120a710882245,416,322729155,9557,22.97
766,5d7cea19459a0d1eba772c1dac3a1b96190c8fbf836ef562173a725957b15ded,224,2557420,5d7cea19459a0d1eba772c1dac3a1b96190c8fbf836ef562173a725957b15ded,224,2553741,3679,16.42
767,9f87da2d97b5abdabfd75eafff91865fddfb78117165be1c94829a9c4c83fa54,370,2492528,9f87da2d97b5abdabfd75eafff91865fddfb78117165be1c94829a9c4c83fa54,370,2476642,15886,42.94
768,b4f85b522839b5f4e414e575ebf43b5c8ce888353d969b4b5e8cf677cd4ebc99,925,507797,b4f85b522839b5f4e414e575ebf43b5c8ce888353d969b4b5e8cf677cd4ebc99,925,492885,14912,16.12
769,cbfb8f5e47ad8bbb0d6c85aa70391a87b504b41a32df2ef9e41f217ac497306e,223,100000,cbfb8f5e47ad8bbb0d6c85aa70391a87b504b41a32df2ef9e41f217ac497306e,223,94048,5952,26.69
770,dfdae8fde72595f3f34786615f5039a1a360b0ad62436dc217d29a9ad20fc5c6,372,717134,dfdae8fde72595f3f34786615f5039a1a360b0ad62436dc217d29a9ad20fc5c6,372,715673,1461,3.93
771,44566a0e62040fbb1720be655f7b29740709fd9cf1710636d947e25d9e637636,191,880899,44566a0e62040fbb1720be655f7b29740709fd9cf1710636d947e25d9e637636,191,875091,5808,30.41
772,5e0e92c8b920da7142fe45313a1b16a92b0a91184348dbf9f597f52aa0a6fc4a,226,4252102,5e0e92c8b920da7142fe45313a1b16a92b0a91184348dbf9f597f52aa0a6fc4a,226,4249380,2722,12.04
773,858653f3e0db95b1641e4ad8de3ca1ffe66773fa12b4188da2da85eaabab6c9f,489,1197670,858653f3e0db95b1641e4ad8de3ca1ffe66773fa12b4188da2da85eaabab6c9f,489,1195955,1715,3.51
774,8a1a9ddd0b254ca7e1432b74c76bf836e3501203a21f8776f8938b507e9c333e,247,293679,8a1a9ddd0b254ca7e1432b74c76bf836e3501203a21f8776f8938b507e9c333e,247,292359,1320,5.34
775,fbc92ce438e23a0c413855001c3b6dc056b56a34d5a33c295c5202ddb0cb9275,222,374433250,fbc92ce438e23a0c413855001c3b6dc056b56a34d5a33c295c5202ddb0cb9275,222,374431981,1269,5.72
776,a6aac88066d56cf01be628193b36d90a9d840904d0c618ca5f35f5829983a647,342,2803099,a6aac88066d56cf01be628193b36d90a9d840904d0c618ca5f35f5829983a647,342,2799489,3610,10.56
777,07b3c992a53e1d4a0d615c236718f132976a90ba5cd0c43fe171918549ced4a9,2548,636121,07b3c992a53e1d4a0d615c236718f132976a90ba5cd0c43fe171918549ced4a9,2548,590041,46080,18.08
778,24386e59d60bf0e788598e2f730d6309dd0224e21322ef3e45b2fd02a6842c7e,225,16090876,24386e59d60bf0e788598e2f730d6309dd0224e21322ef3e45b2fd02a6842c7e,225,16083676,7200,32
779,6cf8cb7d569207cb14a13684a9774b102188a6cbf4073ecc9fe4de344c98946b,191,67906,6cf8cb7d569207cb14a13684a9774b102188a6cbf4073ecc9fe4de344c98946b,191,65242,2664,13.95
780,765467f24d80982faf310aee7c368253bc1f4b1e12159018b8cd61b846d1214f,222,35160666,765467f24d80982faf310aee7c368253bc1f4b1e12159018b8cd61b846d1214f,222,35156226,4440,20
781,eb434cb643601e91577475f23777866ea5bf84c09d327db563b23f15fe11c49e,420,105033872,eb434cb643601e91577475f23777866ea5bf84c09d327db563b23f15fe11c49e,420,105025145,8727,20.78
782,ed661633c360feb3cb969d3dbe88b34e0676789ab3e24723ca25f5fea4304dc6,195,730000,ed661633c360feb3cb969d3dbe88b34e0676789ab3e24723ca25f5fea4304dc6,195,718474,11526,59.11
783,44cc205bd2024db896503b7f7c51e89092c70fcb9178f60c4d219661f1d3b25d,205,99891859,44cc205bd2024db896503b7f7c51e89092c70fcb9178f60c4d219661f1d3b25d,205,99890473,1386,6.76
784,635c99fbf9fb6228ea72d3abaaf1aa884513067df574ca1bdcf85469bd9e2e26,224,16379406,635c99fbf9fb6228ea72d3abaaf1aa884513067df574ca1bdcf85469bd9e2e26,224,16375346,4060,18.12
785,ad695970b021f2074443acb144885faafbdc2b8078bbbe20f0e05c553d70aa58,191,2259960,ad695970b021f2074443acb144885faafbdc2b8078bbbe20f0e05c553d70aa58,191,2257100,2860,14.97
786,f0eb73174020f05ce0942a8b8027a4c779731d77c045b74ff2b88dca48632add,522,766580,f0eb73174020f05ce0942a8b8027a4c779731d77c045b74ff2b88dca48632add,522,760383,6197,11.87
787,082b2bfa93ee2a99f5c6cf9b42972373ee306a736a3b1e82e5c14440581cb98e,487,217798,082b2bfa93ee2a99f5c6cf9b42972373ee306a736a3b1e82e5c14440581cb98e,487,211380,6418,13.18
788,85658278da7611eb06734bbcd1095d89b7ce8ff0c14fcd1cb6fc9d8d31b61544,193,166049,85658278da7611eb06734bbcd1095d89b7ce8ff0c14fcd1cb6fc9d8d31b61544,193,163163,2886,14.95
789,9a21348e48857393dbadcd109f2b9642cf7b0ca69b74d49f183d489a6818ded4,222,6600876,9a21348e48857393dbadcd109f2b9642cf7b0ca69b74d49f183d489a6818ded4,222,6597230,3646,16.42
790,10c062277b31b0687d80eff55931b92643ba945696dade09e8c5270f2a45b1a2,380,11661693,10c062277b31b0687d80eff55931b92643ba945696dade09e8c5270f2a45b1a2,380,11656384,5309,13.97
791,979a89118e986237b661db53e0c13ed14613a8e459aad38ed3b7e1c3d64a296f,1076,1434588043,979a89118e986237b661db53e0c13ed14613a8e459aad38ed3b7e1c3d64a296f,1076,1434562378,25665,23.85
792,a038ed6c4a463fb51014b9f791b775888a0f952110f2436d23d843c67384a295,224,38686958,a038ed6c4a463fb51014b9f791b775888a0f952110f2436d23d843c67384a295,224,38683266,3692,16.48
793,0968ca13758a0cb84984228446deed82a017db0d7dfa973026a924637b75035c,405,6433,0968ca13758a0cb84984228446deed82a017db0d7dfa973026a924637b75035c,405,5000,1433,3.54
794,0c0427aca66525a42c000b703236e00f1daa865c418615c5294d0e8a65a71146,234,1150098,0c0427aca66525a42c000b703236e00f1daa865c418615c5294d0e8a65a71146,234,1148108,1990,8.5
795,456dad523128449f6a524f10aa01121824bd7db23ab4a735900c31e5a4ff49b8,223,770780,456dad523128449f6a524f10aa01121824bd7db23ab4a735900c31e5a4ff49b8,223,767114,3666,16.44
796,6dfc475887d4be66478e13efaa94c7bfd55c547f1b51ead85134b908ea0e694d,312,247860,6dfc475887d4be66478e13efaa94c7bfd55c547f1b51ead85134b908ea0e694d,312,246588,1272,4.08
797,c6fd7abb62aaf1c425aef1d749ff4a0760f22b7f470cfa061bbe11bf1b5794f6,224,323966,c6fd7abb62aaf1c425aef1d749ff4a0760f22b7f470cfa061bbe11bf1b5794f6,224,320274,3692,16.48
798,f5555f9a7857148adfb55bce19efa9f7cc1dab633e1a114dea838204dc524cec,77173,260253609,f5555f9a7857148adfb55bce19efa9f7cc1dab633e1a114dea838204dc524cec,77173,259602139,651470,8.44
799,fdf64b5cefbd3dea10165241219718c44260a66ff760cb0c5809ea1d24b98554,223,161075,fdf64b5cefbd3dea10165241219718c44260a66ff760cb0c5809ea1d24b98554,223,157409,3666,16.44
800,0ad279117b7285d3b9fd298a40c1f1a373ec791e95f44275407df81c83cd4e2e,524,399546002,0ad279117b7285d3b9fd298a40c1f1a373ec791e95f44275407df81c83cd4e2e,524,399538952,7050,13.45
801,428201d6a622850648dbeede0b4422e3281b0e85a67e9a99caba9b49c65f14a4,222,100000000,428201d6a622850648dbeede0b4422e3281b0e85a67e9a99caba9b49c65f14a4,222,99998003,1997,9
802,42fd7484da5d5ff38a15ccc9decd0688996bf2eee6184d7fdc61514941285555,338,147924,42fd7484da5d5ff38a15ccc9decd0688996bf2eee6184d7fdc61514941285555,338,140598,7326,21.67
803,52d1f45070e904634a51096e2fee9a227570e51f1e90c16e0aa5d18856421be0,223,1484500,52d1f45070e904634a51096e2fee9a227570e51f1e90c16e0aa5d18856421be0,223,1479000,5500,24.66
804,6069f2e6b5901ef39da5c25728a0c19af75c5cb87abf882002a1558f8b8fd31f,194,1526135,6069f2e6b5901ef39da5c25728a0c19af75c5cb87abf882002a1558f8b8fd31f,194,1523197,2938,15.14
805,17af9c78025f7406a8bdbb8e50547467d8d877622b6df2471964656726ddd3f3,223,4276808,17af9c78025f7406a8bdbb8e50547467d8d877622b6df2471964656726ddd3f3,223,4273676,3132,14.04
806,1d15ea816fdbac0fc17953dd752b8c5c7999e438517ab3edb351272f562a24a0,359,7000,1d15ea816fdbac0fc17953dd752b8c5c7999e438517ab3edb351272f562a24a0,359,5344,1656,4.61
807,3c18cf0518378a213019cb94af6da2781e9377a2385d05ec921489a7397b1f95,192,526596,3c18cf0518378a213019cb94af6da2781e9377a2385d05ec921489a7397b1f95,192,523710,2886,15.03
808,63d6554b5d97145ed2d97d15533840898e2e9a49f8b6eca6091e481c853d79e6,343,4966419,63d6554b5d97145ed2d97d15533840898e2e9a49f8b6eca6091e481c853d79e6,343,4965157,1262,3.68
809,b18ef3ac1f513486294a7452706dac3817e634acb1a8a751674e08111636a99f,254,411989,b18ef3ac1f513486294a7452706dac3817e634acb1a8a751674e08111636a99f,254,410420,1569,6.18
810,8a00494908081bdfc335a83d360bd286e59992bf287f0273753bd6a8887f16e6,222,20833017,8a00494908081bdfc335a83d360bd286e59992bf287f0273753bd6a8887f16e6,222,20830041,2976,13.41
811,955d2e6cd37673bfec6cb248c59df8bbb1657d82ba0ce09aa9b30c9ebdcf5acc,222,3152273,955d2e6cd37673bfec6cb248c59df8bbb1657d82ba0ce09aa9b30c9ebdcf5acc,222,3149163,3110,14.01
812,4152d8f2b7bd2a184357e817f0edd8b2d76fa9b4a588effd64a0d40ab31be231,248,116782728,4152d8f2b7bd2a184357e817f0edd8b2d76fa9b4a588effd64a0d40ab31be231,248,116768452,14276,57.56
813,54d40006ed9bb626dd238b846c3447534615ea70e663017eb9b35e92d6da95b8,818,86758070,54d40006ed9bb626dd238b846c3447534615ea70e663017eb9b35e92d6da95b8,818,86742224,15846,19.37
814,ab71d011614ad2731966501e5d52112fb3775cacdc79f59096e3d63787691e86,490,53921267,ab71d011614ad2731966501e5d52112fb3775cacdc79f59096e3d63787691e86,490,53911901,9366,19.11
815,b0374124eef37ea233eceb3f5529adac80e2c14002d600bd03f0a6fc47d34ff6,154,5000,b0374124eef37ea233eceb3f5529adac80e2c14002d600bd03f0a6fc47d34ff6,154,4384,616,4
816,59bb2b22f14c46f1e6fb0f25dd48ea59680d95546a4e5f56e4c84581d52ce215,226,2719790,59bb2b22f14c46f1e6fb0f25dd48ea59680d95546a4e5f56e4c84581d52ce215,226,2714214,5576,24.67
817,916a0aa974a782e4a0b0a678359af32500624d3e29cf1ef09c5dd95584f029d4,373,594200,916a0aa974a782e4a0b0a678359af32500624d3e29cf1ef09c5dd95584f029d4,373,590451,3749,10.05
818,dd0867047c578a630cd1209046c28f016c01f30c7462abf2024e5fea66e26d55,371,259819,dd0867047c578a630cd1209046c28f016c01f30c7462abf2024e5fea66e26d55,371,255868,3951,10.65
819,e4ef4e7abb65e2a24668737785d82e79b26d33a7c6867dbc5b527bdbb83b3232,223,280702,e4ef4e7abb65e2a24668737785d82e79b26d33a7c6867dbc5b527bdbb83b3232,223,276472,4230,18.97
820,540565f6ec8fd2d93303c3f24eeb131a120909a8d4e443d0560560f323849dda,372,2078489,540565f6ec8fd2d93303c3f24eeb131a120909a8d4e443d0560560f323849dda,372,2073029,5460,14.68
821,ba66f63ffd75e5598cf7c28d80718338225d033abe6a59750e8fa23eec66c76e,224,147927,ba66f63ffd75e5598cf7c28d80718338225d033abe6a59750e8fa23eec66c76e,224,145243,2684,11.98
822,15e194d83834897e74405ec9ae400b85b5b6f04783d2752a63fe3a2f86771a83,222,1034764,15e194d83834897e74405ec9ae400b85b5b6f04783d2752a63fe3a2f86771a83,222,1030711,4053,18.26
823,3a77dc45ff56b993ee8ef4a19bfa7d0c9695322b9b39ba1c023f93e30caec911,248,145589,3a77dc45ff56b993ee8ef4a19bfa7d0c9695322b9b39ba1c023f93e30caec911,248,140472,5117,20.63
824,c935089a7723dfc4c89e0885eb7625ca8c795324945eef27abcad46fd974abe3,195,1088516,c935089a7723dfc4c89e0885eb7625ca8c795324945eef27abcad46fd974abe3,195,1085578,2938,15.07
825,fdb488565c40bd4d3f87805249c7491842442ab7f53951eaac3804e14b7483f5,222,350342,fdb488565c40bd4d3f87805249c7491842442ab7f53951eaac3804e14b7483f5,222,346676,3666,16.51
826,135ebe5221ed4aa8c1fb9db292f9d58135f2917bf76adf3ffd7fd3509c806d69,214,112035,135ebe5221ed4aa8c1fb9db292f9d58135f2917bf76adf3ffd7fd3509c806d69,214,107700,4335,20.26
827,271db436a589eed5c7cc8b17cfa56485bcc755e781b317cf26a5de232fb273e2,223,759042,271db436a589eed5c7cc8b17cfa56485bcc755e781b317cf26a5de232fb273e2,223,758056,986,4.42
828,4e976c68fbaa33ee5761207933e87fc3bb055e23b581aa7ec710bbcf34eefdfd,223,7080652,4e976c68fbaa33ee5761207933e87fc3bb055e23b581aa7ec710bbcf34eefdfd,223,7077102,3550,15.92
829,e69b6899a900e6e2d6bb1f67e4ad907f5fbe3efe83966a7b4df44f0979d92e4a,506,97096,e69b6899a900e6e2d6bb1f67e4ad907f5fbe3efe83966a7b4df44f0979d92e4a,506,87918,9178,18.14
830,02bc9373adf538482350dd7cb87fefc267855f366577ec9a518f059cd100da8b,226,6971909,02bc9373adf538482350dd7cb87fefc267855f366577ec9a518f059cd100da8b,226,6968192,3717,16.45
831,0b56d478338785786ef0f0c33c4ddf84ab75f03360fcc2767d49875d102a7d53,250,25385232,0b56d478338785786ef0f0c33c4ddf84ab75f03360fcc2767d49875d102a7d53,250,25378176,7056,28.22
832,1895669465020c9e39b68ecda5a93a0f1c6b015f4318991bfb2a97968c401668,222,517289,1895669465020c9e39b68ecda5a93a0f1c6b015f4318991bfb2a97968c401668,222,512551,4738,21.34
833,515636ecda8046a0a9ea3865c15af4caf2448445cf98d73417fb21a36f67b5e4,193,1727094,515636ecda8046a0a9ea3865c15af4caf2448445cf98d73417fb21a36f67b5e4,193,1724403,2691,13.94
834,657a48729e01f058a9cfeda54a8e115c8bc9173a6f61e9bbf57f6c2352ef76c4,154,2500,657a48729e01f058a9cfeda54a8e115c8bc9173a6f61e9bbf57f6c2352ef76c4,154,1114,1386,9
835,74e8fea9d6e16a73b11815e93b3195cd44710cdfb4a31ce2b48d7501b7ce65fd,223,101889879,74e8fea9d6e16a73b11815e93b3195cd44710cdfb4a31ce2b48d7501b7ce65fd,223,101886238,3641,16.33
836,82d47ff5ac16df4fe00b5d3ac2803c8d2c6d0f32a3b1ab28aa332ada1bff938a,191,650000,82d47ff5ac16df4fe00b5d3ac2803c8d2c6d0f32a3b1ab28aa332ada1bff938a,191,647140,2860,14.97
837,922868202ee40014592401ce8af080793d85bd83e1af4a2f4ce0755b7479782c,247,204968,922868202ee40014592401ce8af080793d85bd83e1af4a2f4ce0755b7479782c,247,203646,1322,5.35
838,bbe84d3401ac9ac76f1a889c52f5a1f277f66d0736cd900ebe83b3b7b8a99f73,192,84220,bbe84d3401ac9ac76f1a889c52f5a1f277f66d0736cd900ebe83b3b7b8a99f73,192,81007,3213,16.73
839,103c7de9e7a8c7d69aa8c0fa11452f92729a6c2c6f213faba58779877fe647b5,215,715121,103c7de9e7a8c7d69aa8c0fa11452f92729a6c2c6f213faba58779877fe647b5,215,714188,933,4.34
840,1bd019d93e6810d1f82bd2546dc0123f7d18ad8b7097e4280ab1916628a92f40,194,613032,1bd019d93e6810d1f82bd2546dc0123f7d18ad8b7097e4280ab1916628a92f40,194,610094,2938,15.14
841,229d6dc3b9af237ce705ab3d8793e463843cc8adc216f1f5dbd399fe265d2ff1,224,2085868,229d6dc3b9af237ce705ab3d8793e463843cc8adc216f1f5dbd399fe265d2ff1,224,2084882,986,4.4
842,4e715ab1d83278f7fd7249ec99d435feaf5299743dc3721c90a82a598c9c306d,517,1099444,4e715ab1d83278f7fd7249ec99d435feaf5299743dc3721c90a82a598c9c306d,517,1097379,2065,3.99
843,8058c88c77b21567afbb7af26da0a299682f7108153d2caca9457846720415ae,223,873740,8058c88c77b21567afbb7af26da0a299682f7108153d2caca9457846720415ae,223,869687,4053,18.17
844,dd0d2eac2e0677dbe026ee661fed4d32bfbf3e446d47f92864945b864e0fa1df,225,380724,dd0d2eac2e0677dbe026ee661fed4d32bfbf3e446d47f92864945b864e0fa1df,225,376664,4060,18.04
845,f4c316fbbda5976285e8901a49adddcad8a042c3d1bf17ccaa68d272b7e7b93c,192,1955,f4c316fbbda5976285e8901a49adddcad8a042c3d1bf17ccaa68d272b7e7b93c,192,1162,793,4.13
846,08815a7edf7c74bb20b094dbf57e301e771cf127fdf47ba73d0d798f3add5628,222,3233489,08815a7edf7c74bb20b094dbf57e301e771cf127fdf47ba73d0d798f3add5628,222,3230379,3110,14.01
847,49283202f89df02e779ebae9075789aed5bd8b88ec16b72c924ed37e91f715ce,234,3398000,49283202f89df02e779ebae9075789aed5bd8b88ec16b72c924ed37e91f715ce,234,3393352,4648,19.86
848,796c7b6bd53a97a89e5a155d856a894d8b7696ba88e79448425d86f71bb5127a,222,180774434,796c7b6bd53a97a89e5a155d856a894d8b7696ba88e79448425d86f71bb5127a,222,180768586,5848,26.34
849,9cd3541da46852494bebee998a271113f728ead6aa15b1d57f783360733fcdc2,402,14000,9cd3541da46852494bebee998a271113f728ead6aa15b1d57f783360733fcdc2,402,11957,2043,5.08
850,d0706e362a520b670b784987bee1ed465147254424d70c81f1c8f7d47d9c418b,414,27209864,d0706e362a520b670b784987bee1ed465147254424d70c81f1c8f7d47d9c418b,414,27197824,12040,29.08
851,fadb54553abddbb549e1a52ac0e88c710df981e6ec7614683ddf5dd5d297d59a,371,1984106,fadb54553abddbb549e1a52ac0e88c710df981e6ec7614683ddf5dd5d297d59a,371,1976582,7524,20.28
852,0f34ad1e124a769dfb8ab74598377edbb90ff91faee8446ed92e92d1c39429b7,225,1374609,0f34ad1e124a769dfb8ab74598377edbb90ff91faee8446ed92e92d1c39429b7,225,1371420,3189,14.17
853,64ab56f849021fe53e3d5a40fdf3ea89edb7141af96dfa26b70589a9ad5b60c5,257,190791700,64ab56f849021fe53e3d5a40fdf3ea89edb7141af96dfa26b70589a9ad5b60c5,257,190785000,6700,26.07
854,a0ea2f40bc9b92c95345286f92c9f1d3789948ff27ce11d210fc739812613365,249,31400,a0ea2f40bc9b92c95345286f92c9f1d3789948ff27ce11d210fc739812613365,249,26528,4872,19.57
855,a577c32c791b5c9c7f78e00a65b2bb0b8b4eca9d2339f452902f760d2eb34b52,222,47550,a577c32c791b5c9c7f78e00a65b2bb0b8b4eca9d2339f452902f760d2eb34b52,222,41752,5798,26.12
856,de942ad87951bbff49d26bbebc9c92adfad6187ed1df58a38d87509f29c7f3b6,249,126801,de942ad87951bbff49d26bbebc9c92adfad6187ed1df58a38d87509f29c7f3b6,249,125312,1489,5.98
857,9d3ab0ad884bcd62494f00cd118e522acc52b5f9918356bb258297792790a381,349,24662334,9d3ab0ad884bcd62494f00cd118e522acc52b5f9918356bb258297792790a381,349,24638058,24276,69.56
858,ad0697a8e8d9778f0baf623b02c4a62e60dbdd3db97272bc875d857f33d538dc,222,566400,ad0697a8e8d9778f0baf623b02c4a62e60dbdd3db97272bc875d857f33d538dc,222,560900,5500,24.77
859,d963d114b0384fae7e23d9a5438908ac3126f494e7d6ff8ac149fd8cbf6b0201,371,17849443,d963d114b0384fae7e23d9a5438908ac3126f494e7d6ff8ac149fd8cbf6b0201,371,17843396,6047,16.3
860,f52cb2afad83043623bf6fe9ae82042f54889d6e79382f6988a421339be18b73,225,564288,f52cb2afad83043623bf6fe9ae82042f54889d6e79382f6988a421339be18b73,225,560696,3592,15.96
861,fbc8f9b7f09e8a0e18a95254410cd2e7a74718e9117b8f12c61a4ffa600824ce,224,523145,fbc8f9b7f09e8a0e18a95254410cd2e7a74718e9117b8f12c61a4ffa600824ce,224,519453,3692,16.48
862,428c80f8c9b2c8d892411bd3e87b9e7f2464271144512f665597c69d52af812f,191,602366,428c80f8c9b2c8d892411bd3e87b9e7f2464271144512f665597c69d52af812f,191,597674,4692,24.57
863,9b32393cff98fb8b2f503000ccd0f00fc9f49c43c21d87f79fff5d79888a67a3,223,4427740,9b32393cff98fb8b2f503000ccd0f00fc9f49c43c21d87f79fff5d79888a67a3,223,4423672,4068,18.24
864,c298f19c520b60f39a33c6de21b0cd24dc3eb7a240a96a9fad88677028c60a8e,371,43449,c298f19c520b60f39a33c6de21b0cd24dc3eb7a240a96a9fad88677028c60a8e,371,39774,3675,9.91
865,228f1c46f3dc14fc48fd62a17321bb5e0ebfce0c91d9f71ec3499c6c471c34bf,533,8226390,228f1c46f3dc14fc48fd62a17321bb5e0ebfce0c91d9f71ec3499c6c471c34bf,533,8198790,27600,51.78
866,47de4a31ff6c0df22639f8fee801d0297df30f06a9ba6526b06149b3508f9648,1805,2912509,47de4a31ff6c0df22639f8fee801d0297df30f06a9ba6526b06149b3508f9648,1805,2901613,10896,6.04
867,7e6df88d67adaf5dd29a6b007beedd0dee1539e388cd9a0be1b39c5b2e638256,224,16092180006,7e6df88d67adaf5dd29a6b007beedd0dee1539e388cd9a0be1b39c5b2e638256,224,16092176073,3933,17.56
868,b0cb833218e7362619a20f123aa3f2581a3fe28829c879b9a9fae69e906052b5,223,137865,b0cb833218e7362619a20f123aa3f2581a3fe28829c879b9a9fae69e906052b5,223,136297,1568,7.03
869,f642471c8104bb4f78de675b1fee9209d2f82fd8f6bc1418fc84915506f1be0d,226,1567069,f642471c8104bb4f78de675b1fee9209d2f82fd8f6bc1418fc84915506f1be0d,226,1562929,4140,18.32
870,0b2699bb1848931920df5b13dc9690163b98122781a096cb56ded5ae64e0708d,222,1198322,0b2699bb1848931920df5b13dc9690163b98122781a096cb56ded5ae64e0708d,222,1197061,1261,5.68
871,0c835a8035c96a93c056e0ac6a8c7c96978c822c4de33adc6be40ac0f39d8483,563,17182421,0c835a8035c96a93c056e0ac6a8c7c96978c822c4de33adc6be40ac0f39d8483,563,17175588,6833,12.14
872,ee40f95cd69f011b8d4a63ba926c2f8fb5a193b3de072d2a112c08b2359211ab,223,26420101,ee40f95cd69f011b8d4a63ba926c2f8fb5a193b3de072d2a112c08b2359211ab,223,26416601,3500,15.7
873,0457c5439fd780410878441c2b65eb332c39929f39ece74e52b153a35f0afbcd,852,42541760,0457c5439fd780410878441c2b65eb332c39929f39ece74e52b153a35f0afbcd,852,42525860,15900,18.66
874,36f84d6d1e1514950a0e31834afc5349d3ce1b79d9e0a532535ea6c13624059a,520,506047,36f84d6d1e1514950a0e31834afc5349d3ce1b79d9e0a532535ea6c13624059a,520,501084,4963,9.54
875,8aea10743f2675a3dd7482f099a869385a2af1ac111b17f8a66158b6e90552b3,250,11799197,8aea10743f2675a3dd7482f099a869385a2af1ac111b17f8a66158b6e90552b3,250,11794674,4523,18.09
876,8ff1c454195dfcea7cd06a100088b16c824aa7cbbcd2ad9cf63841fb60fc19b8,248,110978,8ff1c454195dfcea7cd06a100088b16c824aa7cbbcd2ad9cf63841fb60fc19b8,248,110135,843,3.4
877,e8eba69474a8f40626fd7d96caf3b4e667bb9e770c310d115fab379a32e4e6c7,226,134688,e8eba69474a8f40626fd7d96caf3b4e667bb9e770c310d115fab379a32e4e6c7,226,130944,3744,16.57
878,ddea6b48800d6e0461eb94e2e5bdb61fba1e16be097d274ceb7ae34db92d40b6,215,70734,ddea6b48800d6e0461eb94e2e5bdb61fba1e16be097d274ceb7ae34db92d40b6,215,66790,3944,18.34
879,0af5fe1c2c6f2da8cd264e38d21be28cfe143ff88bfdb6c949c54aeb8c639406,222,68460,0af5fe1c2c6f2da8cd264e38d21be28cfe143ff88bfdb6c949c54aeb8c639406,222,64407,4053,18.26
880,2f46584229f21cd4498c8368cac46700054742fdbaa46ddc5fbd833cbaebb5ea,236,228783,2f46584229f21cd4498c8368cac46700054742fdbaa46ddc5fbd833cbaebb5ea,236,227938,845,3.58
881,4b53ff491113c6ec8e1924e6addf915d7fe16a9801efc2506712ed83f81c21db,224,5041031,4b53ff491113c6ec8e1924e6addf915d7fe16a9801efc2506712ed83f81c21db,224,5037750,3281,14.65
882,606967bf657e9260134e181e7737ad4a4d0415d2dd35f7914aba7b29b36d913c,371,2875851,606967bf657e9260134e181e7737ad4a4d0415d2dd35f7914aba7b29b36d913c,371,2870430,5421,14.61
883,6be2cbf806f9e1bf5534380b24a114980a43a435a4569e275f5be6cfa6766d17,534,8049390,6be2cbf806f9e1bf5534380b24a114980a43a435a4569e275f5be6cfa6766d17,534,8021790,27600,51.69
884,32d17e4db2b7af4a68e4299b13fcf487f4a9068c883e41718982060c9a77f7f0,193,39851,32d17e4db2b7af4a68e4299b13fcf487f4a9068c883e41718982060c9a77f7f0,193,36965,2886,14.95
885,4b1212bf9e8173550bc403f8e0f108fec2615007a4315e882f76d5227a6f2e46,887,9485,4b1212bf9e8173550bc403f8e0f108fec2615007a4315e882f76d5227a6f2e46,887,6533,2952,3.33
886,adbd9fa6b77fceaa0b74e8895424e5f29cbb8ff266abce8c7cccaac23f0d948c,223,6887063,adbd9fa6b77fceaa0b74e8895424e5f29cbb8ff266abce8c7cccaac23f0d948c,223,6884694,2369,10.62
887,deae782de2c365eef92e862776f82426aedac8009b975ea4a9ffcf343dc458ac,197,2558599,deae782de2c365eef92e862776f82426aedac8009b975ea4a9ffcf343dc458ac,197,2553373,5226,26.53
888,e7fd4019950fe760a5e96103813397fbce23ad590b8ba78cda4472eea5aaf573,269,1775984333,e7fd4019950fe760a5e96103813397fbce23ad590b8ba78cda4472eea5aaf573,269,1775976406,7927,29.47
889,ee52da91e4b32e6d2d903ce68d3ea025916986b96070b9a9e8759dd09eeea678,519,2733382,ee52da91e4b32e6d2d903ce68d3ea025916986b96070b9a9e8759dd09eeea678,519,2725457,7925,15.27
890,f7633e46d76945a90ed5d0ebc2400daea2e9f5dd1aec97989136a1ccfafdff50,234,4022908,f7633e46d76945a90ed5d0ebc2400daea2e9f5dd1aec97989136a1ccfafdff50,234,4019169,3739,15.98
