,hash,trans_size,sum(in_value),hash,size,sum(out_value),trans_fees,trans_fees_2
0,01e2b23f18d5b73b4035eb41250739dd36564be08faf15d09f3ef1b279f180c5,382,1936328,01e2b23f18d5b73b4035eb41250739dd36564be08faf15d09f3ef1b279f180c5,382,1933600,2728,7.14
1,0e6f3a95c158ce8a0462ad2d709d09bf560ac8b32994e974aa021e2f1bce8420,225,1024216,0e6f3a95c158ce8a0462ad2d709d09bf560ac8b32994e974aa021e2f1bce8420,225,1022454,1762,7.83
2,1167771c482f7dc88b6056d93be99ee76c8202357ecea1f1fb7fdf0ae11215dd,222,10219391,1167771c482f7dc88b6056d93be99ee76c8202357ecea1f1fb7fdf0ae11215dd,222,10213165,6226,28.05
3,9aaf96d9b26f0dcd94c0a94d4ba34a9c4b9145ca84fa52b640aee6e52af2447c,192,21208,9aaf96d9b26f0dcd94c0a94d4ba34a9c4b9145ca84fa52b640aee6e52af2447c,192,19534,1674,8.72
4,9feaefb5ad52a73c6bcf59ec457186166f482b5af9e4367a258be69214073eaa,223,1472788,9feaefb5ad52a73c6bcf59ec457186166f482b5af9e4367a258be69214073eaa,223,1467458,5330,23.9
5,b49bd885f804f3dd84e6ac638c76fedf8faa487cdd8d88848043d75764bc7931,194,2097152,b49bd885f804f3dd84e6ac638c76fedf8faa487cdd8d88848043d75764bc7931,194,2093552,3600,18.56
6,00edfa2331b94ae4a1efe27a2feb7a20bc6712efd72355fc2dd486c107e9d8ce,223,343448,00edfa2331b94ae4a1efe27a2feb7a20bc6712efd72355fc2dd486c107e9d8ce,223,341333,2115,9.48
7,1402dccae3edd464c04479b10524889e3d79ad9a2323616badb065797a492e07,225,10958637,1402dccae3edd464c04479b10524889e3d79ad9a2323616badb065797a492e07,225,10956477,2160,9.6
8,566416a84d04144e5fdeaf3a863513b677c6d4f5a9bad3872f7dd4ce3dd6fb17,258,1693056,566416a84d04144e5fdeaf3a863513b677c6d4f5a9bad3872f7dd4ce3dd6fb17,258,1689179,3877,15.03
9,f307ca7849744635bf630b48bb3b3a82ecee0f6939cdf4f94d402ec07cb7985f,14790,215961246,f307ca7849744635bf630b48bb3b3a82ecee0f6939cdf4f94d402ec07cb7985f,14790,215761246,200000,13.52
10,1c8cf09d020270c14a1908089f16601c8b4d7e3b953169f99f67e64c9793a4c3,195,322137,1c8cf09d020270c14a1908089f16601c8b4d7e3b953169f99f67e64c9793a4c3,195,319475,2662,13.65
11,64619e345763303c2cc3cb29f3ed5375c339795c33624447a5d3921fc9dd5a41,372,30133794,64619e345763303c2cc3cb29f3ed5375c339795c33624447a5d3921fc9dd5a41,372,30131286,2508,6.74
12,610589bd53d0f7a8cfdea5fda3e6d7fc94bee3f439726b88efab2ccc78b14577,248,46520931,610589bd53d0f7a8cfdea5fda3e6d7fc94bee3f439726b88efab2ccc78b14577,248,46518939,1992,8.03
13,8a6bc7314c700f76c63bb5040afefdeccd24e249fa4670e10876aaabcb6e87f5,225,1169532,8a6bc7314c700f76c63bb5040afefdeccd24e249fa4670e10876aaabcb6e87f5,225,1167372,2160,9.6
14,de2debcc6b0a1d99aa9217c8a9fa7065053cb3154083d9603f5a97ed21cc33ea,223,2227206,de2debcc6b0a1d99aa9217c8a9fa7065053cb3154083d9603f5a97ed21cc33ea,223,2223968,3238,14.52
15,5af72263048fc3250feb750ec8b75378ccbbb7cdb605592c3b23c335f8ff34ef,225,829278,5af72263048fc3250feb750ec8b75378ccbbb7cdb605592c3b23c335f8ff34ef,225,827458,1820,8.09
16,7ca6c151f55bfdb25162df9f18932c8010c6d9e2509f07eb5818609a9895363f,222,2356375,7ca6c151f55bfdb25162df9f18932c8010c6d9e2509f07eb5818609a9895363f,222,2354119,2256,10.16
17,a389f26a9ec7025065f5c6b3cd5cebb333aa44b376d61b6ebf95081a24feca77,223,191494,a389f26a9ec7025065f5c6b3cd5cebb333aa44b376d61b6ebf95081a24feca77,223,188765,2729,12.24
18,0d7874863fb2726a544e1c5c5b006586c58c45f99a5e76eff0be589b1c095d76,215,844491,0d7874863fb2726a544e1c5c5b006586c58c45f99a5e76eff0be589b1c095d76,215,842873,1618,7.53
19,2c4bdaa4c5f1eb65d401c298e393874c8a97a6b7d371f171a2662b1334c3ec3c,299,34094,2c4bdaa4c5f1eb65d401c298e393874c8a97a6b7d371f171a2662b1334c3ec3c,299,30663,3431,11.47
20,3b1e166054b16892c8f29870dbda0c06b6af6e73a12d06458962b9a6f89fbd4a,14793,151040510,3b1e166054b16892c8f29870dbda0c06b6af6e73a12d06458962b9a6f89fbd4a,14793,150840510,200000,13.52
21,56edfd41067663eec0fee9db07ea31233315eb0d1d3c8116551751f36f2c95c3,1543,967482151,56edfd41067663eec0fee9db07ea31233315eb0d1d3c8116551751f36f2c95c3,1543,967461396,20755,13.45
22,90ffd8b7eedbbec807ee2da4f149ec1d2cd193b6d6cbc4d7e9989f4e1856d948,371,492249,90ffd8b7eedbbec807ee2da4f149ec1d2cd193b6d6cbc4d7e9989f4e1856d948,371,489114,3135,8.45
23,853ddcda79849afb04460d853ff5268db2a2a12852e23982ed466af2028d91db,214,1089801,853ddcda79849afb04460d853ff5268db2a2a12852e23982ed466af2028d91db,214,1089636,165,0.77
24,878bcde45bf708a58439273101186d91c3eaea4f22fd50c18bf9581eeec770e0,194,212414006,878bcde45bf708a58439273101186d91c3eaea4f22fd50c18bf9581eeec770e0,194,212410717,3289,16.95
25,9f9ff0f9e5703259d8b7e59d9fdbb1b28cda2db079b659038672d432a15a6772,744,527962,9f9ff0f9e5703259d8b7e59d9fdbb1b28cda2db079b659038672d432a15a6772,744,518812,9150,12.3
26,ce8e06b7897a768bac60513e93a64544f5f559364fc8d299066c82a0e3645650,222,19750000,ce8e06b7897a768bac60513e93a64544f5f559364fc8d299066c82a0e3645650,222,19740100,9900,44.59
27,4ee987530d3de790875b67c0a2ce572deae1961b72bd42d6c57226d7200023cf,191,7811069,4ee987530d3de790875b67c0a2ce572deae1961b72bd42d6c57226d7200023cf,191,7803929,7140,37.38
28,5731286e4a34169dab43d33f40e52d6682524db7c52b17bdc4da4aa48a804b68,631,603169,5731286e4a34169dab43d33f40e52d6682524db7c52b17bdc4da4aa48a804b68,631,596173,6996,11.09
29,5ca5d648f607cadd875274650d7033761387b22e334707960dbd08b51b3fb76a,190,72078814,5ca5d648f607cadd875274650d7033761387b22e334707960dbd08b51b3fb76a,190,72068118,10696,56.29
30,65ce99bc22e8397ea9d2eca5787868e9ecd4ca8ea9e680ad597ce6b480bb4372,191,183527404,65ce99bc22e8397ea9d2eca5787868e9ecd4ca8ea9e680ad597ce6b480bb4372,191,183475753,51651,270.42
31,a0f65010cdbd63fc768c9081a61c38a65890b261520293c738e6794e3dc98905,189,467150,a0f65010cdbd63fc768c9081a61c38a65890b261520293c738e6794e3dc98905,189,440000,27150,143.65
32,73e578d168d33fbd37d5fdb0f34d2382fb6921fa43664e8b96d3c5feaca2961c,191,139047760,73e578d168d33fbd37d5fdb0f34d2382fb6921fa43664e8b96d3c5feaca2961c,191,139000592,47168,246.95
33,d2a07991eafb05521144bc1c572f695ef40b520c82e684ba0dc22de97dbd20c5,222,479524,d2a07991eafb05521144bc1c572f695ef40b520c82e684ba0dc22de97dbd20c5,222,477409,2115,9.53
34,d76d974938218c4ccd5268a91135276579583c29f3d43f41c8e8d480283c967b,522,426447,d76d974938218c4ccd5268a91135276579583c29f3d43f41c8e8d480283c967b,522,422829,3618,6.93
35,7e5f2b04be93c43a7fcfb5699ed45a0801cd144cb4ed5dd910e1e21dad8b6f3a,530,51842,7e5f2b04be93c43a7fcfb5699ed45a0801cd144cb4ed5dd910e1e21dad8b6f3a,530,51483,359,0.68
36,b9c29415889b6a4bc21db1dcfa2ddaed63dad8c51a3dc39f73fe6ed4db5dd458,375,5955556,b9c29415889b6a4bc21db1dcfa2ddaed63dad8c51a3dc39f73fe6ed4db5dd458,375,5955298,258,0.69
37,c80f66bb2d853f05522b7cab2dac7a825439fbc8ea2c0f25dc5ca54c0f103186,521,399696,c80f66bb2d853f05522b7cab2dac7a825439fbc8ea2c0f25dc5ca54c0f103186,521,395526,4170,8
38,c12619735c531561c601ab28a807f6339021c90e26e37a8fdb9c676d5548396b,225,74423,c12619735c531561c601ab28a807f6339021c90e26e37a8fdb9c676d5548396b,225,72263,2160,9.6
39,4d24335d04f0c8a270046fbabe72c1f249d61a36e7ca718e3dc263995eae0c33,257,15696897,4d24335d04f0c8a270046fbabe72c1f249d61a36e7ca718e3dc263995eae0c33,257,15693797,3100,12.06
40,c74ea972e7121004582d9d6384c8039b37390ad624eb5c72745f9b97cac54547,247,64159290,c74ea972e7121004582d9d6384c8039b37390ad624eb5c72745f9b97cac54547,247,64152650,6640,26.88
41,530268f6bafe0b14ec7fe023571475693232ea043df4060364ce637955e4f0f0,373,790031,530268f6bafe0b14ec7fe023571475693232ea043df4060364ce637955e4f0f0,373,777573,12458,33.4
42,cf8e881f2f4955a274cf9f097dc96ead11e79458441ae432ed2a43e2b9b27ab6,222,1018777,cf8e881f2f4955a274cf9f097dc96ead11e79458441ae432ed2a43e2b9b27ab6,222,1009634,9143,41.18
43,a6bfaaa618b5c4e13b48e01ae737ea85a7483f25a5e10f0a6a0dc671f2163b61,348,65976,a6bfaaa618b5c4e13b48e01ae737ea85a7483f25a5e10f0a6a0dc671f2163b61,348,60602,5374,15.44
44,0e7148ad670411fe15beaf0bb02a80ff4e217cd272f4bda46a082201ed22d5c0,299,182162,0e7148ad670411fe15beaf0bb02a80ff4e217cd272f4bda46a082201ed22d5c0,299,178731,3431,11.47
45,e9c349d2491890d315fc777febc0ef697218a7569a616b95175483455704dc16,350,30070700,e9c349d2491890d315fc777febc0ef697218a7569a616b95175483455704dc16,350,30063394,7306,20.87
46,6b2b41b29116685db2326ab6bc8ab885fb579cadba85f7dcdf0beb5a6a365698,226,92935231,6b2b41b29116685db2326ab6bc8ab885fb579cadba85f7dcdf0beb5a6a365698,226,92933485,1746,7.73
47,a9be8f0302e7b8e239a0f747140854ea7fcf273074c64871c74eb39b9882c078,416,1353406,a9be8f0302e7b8e239a0f747140854ea7fcf273074c64871c74eb39b9882c078,416,1350500,2906,6.99
48,1d3af746916587d7c5907699d8af3417796d4b2b958852cbd6900b06df83617e,193,4977782,1d3af746916587d7c5907699d8af3417796d4b2b958852cbd6900b06df83617e,193,4976117,1665,8.63
49,9d2cdb17bbcf32b545b09b72701e467a66793975872c8b92b103d612a1a91de0,248,3259526,9d2cdb17bbcf32b545b09b72701e467a66793975872c8b92b103d612a1a91de0,248,3256991,2535,10.22
50,a46b82eef42e360576d7b1b528e4b7c0ce4550ca53f689068a835a98bf330e33,373,9667863,a46b82eef42e360576d7b1b528e4b7c0ce4550ca53f689068a835a98bf330e33,373,9665126,2737,7.34
51,ac87b05177b346155435b11a222f2b4da67abd5af57bea6acd0cf3ebbe19829e,521,387322,ac87b05177b346155435b11a222f2b4da67abd5af57bea6acd0cf3ebbe19829e,521,381350,5972,11.46
52,c3838f429ce5e66e82a88502c091d800fae422fce4ad6ca22e53a02e3ba17ec1,191,1032049,c3838f429ce5e66e82a88502c091d800fae422fce4ad6ca22e53a02e3ba17ec1,191,1027414,4635,24.27
53,4633130413d254b851a1212bd60730ebaaf76f5c077b317d43bca0cda7d66164,372,722329,4633130413d254b851a1212bd60730ebaaf76f5c077b317d43bca0cda7d66164,372,717555,4774,12.83
54,4d2ce2615c0669ad92b2dff7a6ddd477acbf2e42435df35da0db8c722e21470c,197,15245717,4d2ce2615c0669ad92b2dff7a6ddd477acbf2e42435df35da0db8c722e21470c,197,15243997,1720,8.73
55,3ee6d9d3e3f4e5064fff78c75fd36dd9f136b50d786056bcd85aa71f14c47770,223,314786,3ee6d9d3e3f4e5064fff78c75fd36dd9f136b50d786056bcd85aa71f14c47770,223,312956,1830,8.21
56,8b165ff25546759ee80b0e7d7d3baa4f8963f2ac2c33e7b4a2063b02e96f7050,246,33811419,8b165ff25546759ee80b0e7d7d3baa4f8963f2ac2c33e7b4a2063b02e96f7050,246,33807141,4278,17.39
57,9ee7f9ed00f48213a7c93472fc3e8bb04fcaa780ca8e0be4a167ad9229f08134,192,8246471,9ee7f9ed00f48213a7c93472fc3e8bb04fcaa780ca8e0be4a167ad9229f08134,192,8241859,4612,24.02
58,23f01c4fa1b70920a2d4b39107eac14112e2252aa2f29c75c0dbec893ebf5cba,591,257691,23f01c4fa1b70920a2d4b39107eac14112e2252aa2f29c75c0dbec893ebf5cba,591,237691,20000,33.84
59,eb6c4921773ca04d4e68e5091550fd0d134399389fdc4a801643626013d2bef2,223,4034095,eb6c4921773ca04d4e68e5091550fd0d134399389fdc4a801643626013d2bef2,223,4032278,1817,8.15
60,6e4f6ca9f5984c2338331df71a9884b7d53682ba94c16088f1d6bc0032eaf5fd,373,646148,6e4f6ca9f5984c2338331df71a9884b7d53682ba94c16088f1d6bc0032eaf5fd,373,638134,8014,21.49
61,916d7b054ef66f915f033d8c7c3ff77dae4ea83ab455b8cdc18f6e25c6df1ffd,341,653880,916d7b054ef66f915f033d8c7c3ff77dae4ea83ab455b8cdc18f6e25c6df1ffd,341,649152,4728,13.87
62,9b4f6cebbb76a3615f0d0956402ecc8905b6dfad72a5da5fb8d21ed760aeb5f2,224,5000000,9b4f6cebbb76a3615f0d0956402ecc8905b6dfad72a5da5fb8d21ed760aeb5f2,224,4997870,2130,9.51
63,d070c82ca531ad1cae72b121e873b7a385e26cd6274554e75d87ee960e6d7e0d,223,985486,d070c82ca531ad1cae72b121e873b7a385e26cd6274554e75d87ee960e6d7e0d,223,983666,1820,8.16
64,0af6c4e7c932cfd3022092460624a893a9600fe08e7aed7bb52e3a8c97c1f3b3,224,87441352,0af6c4e7c932cfd3022092460624a893a9600fe08e7aed7bb52e3a8c97c1f3b3,224,87439586,1766,7.88
65,cb871e1cffd6063a197f00afe6988b52f37582a52615d15a32404e43ae551940,406,1952729,cb871e1cffd6063a197f00afe6988b52f37582a52615d15a32404e43ae551940,406,1946980,5749,14.16
66,e0bff7001a22d7577c275320b67626d5879ccb2d55bdc86ccab7a0151224e3b6,222,19217106,e0bff7001a22d7577c275320b67626d5879ccb2d55bdc86ccab7a0151224e3b6,222,19212106,5000,22.52
67,b708f52177845312d9e105e284019df11e5551da3d6bae4f57cf7a779dcda694,225,320412,b708f52177845312d9e105e284019df11e5551da3d6bae4f57cf7a779dcda694,225,312954,7458,33.15
68,b497ce8147d3d32473989ed34e868a0664cd12ca832946332dba94d3c436220f,223,795455,b497ce8147d3d32473989ed34e868a0664cd12ca832946332dba94d3c436220f,223,793638,1817,8.15
69,e4e177638cd1cac6089cba50f1ca3169ddeb6697a2d68a80d3df6f0fb3c1a719,541,22561987,e4e177638cd1cac6089cba50f1ca3169ddeb6697a2d68a80d3df6f0fb3c1a719,541,22555923,6064,11.21
70,252520a1bdcf462bb747c833566f1c8f35138e0832e7e30a5ac19d4d329b8efa,193,313255,252520a1bdcf462bb747c833566f1c8f35138e0832e7e30a5ac19d4d329b8efa,193,307656,5599,29.01
71,771b50e84d986f36608ee1730b39dd2ef9ce850d3faf58c3b8ec075eb7564ad2,162,8023,771b50e84d986f36608ee1730b39dd2ef9ce850d3faf58c3b8ec075eb7564ad2,162,5403,2620,16.17
72,bc5e5fbad8399de0c6fa86410a96774d73ef60f81db499b87442590119e52545,217,254177,bc5e5fbad8399de0c6fa86410a96774d73ef60f81db499b87442590119e52545,217,251201,2976,13.71
73,33a564f93351a0bec884e27081eabcf9b5c0c54744881bf75b7ce17998bb2062,223,785833166,33a564f93351a0bec884e27081eabcf9b5c0c54744881bf75b7ce17998bb2062,223,785811134,22032,98.8
74,47056c0a7fd4e86b43d488410d7dcc34cd297172aafa21e093d00fd4e51d4c0f,371,2264012,47056c0a7fd4e86b43d488410d7dcc34cd297172aafa21e093d00fd4e51d4c0f,371,2256331,7681,20.7
75,76325a0734026f221a294da106f211b7643184d5c49ad3d471908e728cd80656,406,3106,76325a0734026f221a294da106f211b7643184d5c49ad3d471908e728cd80656,406,2500,606,1.49
76,ca918dd1c2c5bd929f5e5e7abababc7ffd8b33941d0ca24f53cfb28cffd721bf,222,902516,ca918dd1c2c5bd929f5e5e7abababc7ffd8b33941d0ca24f53cfb28cffd721bf,222,897186,5330,24.01
77,4b45fc5b5dc53136d3784947d126ab55d86863701ed1112fa8a6c49df7ed95e4,14787,1461509630,4b45fc5b5dc53136d3784947d126ab55d86863701ed1112fa8a6c49df7ed95e4,14787,1461309630,200000,13.53
78,5eb1b5c4768e50e2d8a7963fea038ba49f8eb1a9997541a2690788b21476782a,224,63682,5eb1b5c4768e50e2d8a7963fea038ba49f8eb1a9997541a2690788b21476782a,224,58184,5498,24.54
79,eca4deffeed0a814c5f428fe7e27cb18c69220d207247e26eff63606374a812a,225,675399,eca4deffeed0a814c5f428fe7e27cb18c69220d207247e26eff63606374a812a,225,674437,962,4.28
80,f4ff822c22eca1c028859efca259deb5fd630cc1ee8c65ff3b1dbfcdf1058a54,222,1439421,f4ff822c22eca1c028859efca259deb5fd630cc1ee8c65ff3b1dbfcdf1058a54,222,1437306,2115,9.53
81,43e7a488e4a10e1bc845d1a7b9555634a170d4bd94987db5a16f32edcbaae283,8614,299295255,43e7a488e4a10e1bc845d1a7b9555634a170d4bd94987db5a16f32edcbaae283,8614,299123391,171864,19.95
82,623c0e3a07ad5465a8ac5439f2056f438513d4f0d39e06958f75347910ec4f5f,226,2980031,623c0e3a07ad5465a8ac5439f2056f438513d4f0d39e06958f75347910ec4f5f,226,2976867,3164,14
83,f4e6871a85d1d974a1897b5cdb7cbdc9902f2a7feddb68eb13be75e50822ecad,446,355923675,f4e6871a85d1d974a1897b5cdb7cbdc9902f2a7feddb68eb13be75e50822ecad,446,355921411,2264,5.08
84,6d35f9f26f9be127ee95184d8afa60f9f0a1915f55484f66c393296c4f4f8e96,191,176246268,6d35f9f26f9be127ee95184d8afa60f9f0a1915f55484f66c393296c4f4f8e96,191,176230017,16251,85.08
85,88528e5c1be1574f5966c88778fa7fb17f764ea582afa29d81e45eeaa63dfa67,6432,3095985,88528e5c1be1574f5966c88778fa7fb17f764ea582afa29d81e45eeaa63dfa67,6432,3078363,17622,2.74
86,b68811aaf9d1c2ea0d5844e544a4705a9b1a22b6cddd5d92b951250fdad81b2b,224,159528,b68811aaf9d1c2ea0d5844e544a4705a9b1a22b6cddd5d92b951250fdad81b2b,224,156787,2741,12.24
87,00e8e93967a6fa12f85a08efd4ef2484ebb06aedd9db56f23d523dc0940c251a,222,4378825,00e8e93967a6fa12f85a08efd4ef2484ebb06aedd9db56f23d523dc0940c251a,222,4375822,3003,13.53
88,887b1a525d1f9612003f744592d87339d43d4890488dca8bbf4f75949bbec5ad,191,217788499,887b1a525d1f9612003f744592d87339d43d4890488dca8bbf4f75949bbec5ad,191,217624769,163730,857.23
89,047a5bd1d0d05a46d0cc1d666df8dfa0ea3e67ce3c95a73e802f1df44296e695,222,3579966,047a5bd1d0d05a46d0cc1d666df8dfa0ea3e67ce3c95a73e802f1df44296e695,222,3565991,13975,62.95
90,6d2bebc42262ff1cf4fc7c7b64cbe4a947d3831c8be3508d2783e51cd012ca75,191,131198537,6d2bebc42262ff1cf4fc7c7b64cbe4a947d3831c8be3508d2783e51cd012ca75,191,131160718,37819,198.01
91,afb1363b6b6dda3d1ec9fdc0930d12764ebf9c0642f064834cef8d036535fcdd,490,407583,afb1363b6b6dda3d1ec9fdc0930d12764ebf9c0642f064834cef8d036535fcdd,490,403784,3799,7.75
92,e1708a92331a0fc78cfd97af3fe6091c4b428d1b46fccc76e6ae351d74b1bea3,223,217562,e1708a92331a0fc78cfd97af3fe6091c4b428d1b46fccc76e6ae351d74b1bea3,223,214324,3238,14.52
93,074714de04d6fa8e73a2dfe6939f1f39aa948d781274f555f5df05c3bdf9821d,402,1589120,074714de04d6fa8e73a2dfe6939f1f39aa948d781274f555f5df05c3bdf9821d,402,1583963,5157,12.83
94,73262ec924ba7854185bd0a90809d55c84386dbae48c722c4f05f9ee0d640067,374,514235,73262ec924ba7854185bd0a90809d55c84386dbae48c722c4f05f9ee0d640067,374,502267,11968,32
95,db4e55c0a8dad67000170960458c0aada92b85fe952c6ef3af1a802bfdd8816d,222,4168609,db4e55c0a8dad67000170960458c0aada92b85fe952c6ef3af1a802bfdd8816d,222,4165523,3086,13.9
96,ea1c3e886c4ed5cdf10962db6217eeb44ff1c1c5d75d3791d1b499d6e64ff1d6,345,31020637,ea1c3e886c4ed5cdf10962db6217eeb44ff1c1c5d75d3791d1b499d6e64ff1d6,345,31018284,2353,6.82
97,1bcf5bac0545f75bbcdc1bd57de8b39a417a60f4a3bd4f2615fcdbeeaeaba565,224,659955,1bcf5bac0545f75bbcdc1bd57de8b39a417a60f4a3bd4f2615fcdbeeaeaba565,224,657017,2938,13.12
98,f457fe7ac851ebcecd17d83bcd44ba8243a180a6e84cbe50100eee45a7a29d2f,249,165350,f457fe7ac851ebcecd17d83bcd44ba8243a180a6e84cbe50100eee45a7a29d2f,249,163166,2184,8.77
99,4a6b84e5c2030ff4cf3fe10a316ca27010da3bcaad8fccf753139bffaa7f6b93,222,9537236,4a6b84e5c2030ff4cf3fe10a316ca27010da3bcaad8fccf753139bffaa7f6b93,222,9531906,5330,24.01
100,a857a996dd45f1721b2d9699b152af8c3bdd2b532ef15928e37bc7357accdeb3,478,40345748,a857a996dd45f1721b2d9699b152af8c3bdd2b532ef15928e37bc7357accdeb3,478,40342088,3660,7.66
101,ea9fd7d4be5df98c44f2ffb939d006324f8b25c359aa0f51dbaec5808c330939,193,328012,ea9fd7d4be5df98c44f2ffb939d006324f8b25c359aa0f51dbaec5808c330939,193,325470,2542,13.17
102,f52b8081ba4463816df29fb5ce1ed8301a25d88be0004de24f20f575b9e73bfe,342,43193434,f52b8081ba4463816df29fb5ce1ed8301a25d88be0004de24f20f575b9e73bfe,342,43139134,54300,158.77
103,74aca3ae2e642b176a7d12bfc8a6b8dab5a47852bc4207a6e291dff8bce36b50,222,99000000,74aca3ae2e642b176a7d12bfc8a6b8dab5a47852bc4207a6e291dff8bce36b50,222,98993720,6280,28.29
104,b2357eb6220c028cc148ce7aea9d3acad028a77fb75b136ae963ce3e620d93db,222,186944,b2357eb6220c028cc148ce7aea9d3acad028a77fb75b136ae963ce3e620d93db,222,184900,2044,9.21
105,b7d58f5bb82531587dab1d78c0c6cd353d9a00ec48ddfa360d022c9187e3ea39,226,6710526,b7d58f5bb82531587dab1d78c0c6cd353d9a00ec48ddfa360d022c9187e3ea39,226,6703294,7232,32
106,cccf3c487d2cfe67b6661a9198456fcf2e4031519e3d1ccf86fdc124257b3b72,1376,16314799,cccf3c487d2cfe67b6661a9198456fcf2e4031519e3d1ccf86fdc124257b3b72,1376,16310833,3966,2.88
107,e250b7d84d0ef3fede8fc8ffc445551cde7a1ea8355bf2ccd6e37da7fe21f1f5,371,1722237,e250b7d84d0ef3fede8fc8ffc445551cde7a1ea8355bf2ccd6e37da7fe21f1f5,371,1711275,10962,29.55
108,2e4128e1d2ac6fc6f5df10a92cd39d31d2b0139500bd17b0c3282c1636109838,224,1782925,2e4128e1d2ac6fc6f5df10a92cd39d31d2b0139500bd17b0c3282c1636109838,224,1781095,1830,8.17
109,f37cbc1d02c011b461ab0677eb87dcd51bc55e49f8426ac8dab7539ed53cd764,222,214352630,f37cbc1d02c011b461ab0677eb87dcd51bc55e49f8426ac8dab7539ed53cd764,222,214348823,3807,17.15
110,6fc83ec71995dbed12290a8c96f396a84ef1b160dc87a5ab971ced742d5b2ac6,223,753433,6fc83ec71995dbed12290a8c96f396a84ef1b160dc87a5ab971ced742d5b2ac6,223,748103,5330,23.9
111,9bbcf12a4d1aca8ffa5078bb1127078b8ae836e449ff04a3cf900a91b792aff4,223,209209952,9bbcf12a4d1aca8ffa5078bb1127078b8ae836e449ff04a3cf900a91b792aff4,223,209207760,2192,9.83
112,c5a29dc915306a0d263d9ecac5aedc717bb7b21b4eb7997a706c79ccf723d10b,288,789643666,c5a29dc915306a0d263d9ecac5aedc717bb7b21b4eb7997a706c79ccf723d10b,288,789611689,31977,111.03
113,03a7a943489732c1d90e7c5b644fddc1c08ef9f7790640b1cf649a01fc354cd8,222,28793143,03a7a943489732c1d90e7c5b644fddc1c08ef9f7790640b1cf649a01fc354cd8,222,28791028,2115,9.53
114,3f44376233ecf459c6da44c63b8e83a5dab460f67338d17436f0b64ef92b0b3c,223,31662090,3f44376233ecf459c6da44c63b8e83a5dab460f67338d17436f0b64ef92b0b3c,223,31659898,2192,9.83
115,7edb3be5a29cbcb840651560983579b8c55b0d1006c015323967f4949582792f,9218,85532951,7edb3be5a29cbcb840651560983579b8c55b0d1006c015323967f4949582792f,9218,85375735,157216,17.06
116,b998134562688f857d723a6064720af271d253c8586e397569968f18bb19aae6,224,186854,b998134562688f857d723a6064720af271d253c8586e397569968f18bb19aae6,224,185034,1820,8.12
117,365ed909f1cd257c95094c0c6a50e0b54d0ffd8c618a06d6ea87a655a7a35ef8,372,500251,365ed909f1cd257c95094c0c6a50e0b54d0ffd8c618a06d6ea87a655a7a35ef8,372,497540,2711,7.29
118,c6aa13a152b8640abf5d155a997eea4850fb56b9bb686bd3a885ee48a440be30,224,82492,c6aa13a152b8640abf5d155a997eea4850fb56b9bb686bd3a885ee48a440be30,224,80662,1830,8.17
119,974f7738415a60c21793a23fe8a44bb3549031371fc5c82c7d69b37fffbb84ad,223,143150,974f7738415a60c21793a23fe8a44bb3549031371fc5c82c7d69b37fffbb84ad,223,137820,5330,23.9
120,e33ba3e6897322d43b2469ecab724ac9affbc72d7b624efdf3b4ca0066b10d42,382,5689096,e33ba3e6897322d43b2469ecab724ac9affbc72d7b624efdf3b4ca0066b10d42,382,5684271,4825,12.63
121,549b4ec40fcebdc3d455ad07861e302c0e1d2660854411edd4d85cb67625fbfd,194,72657111,549b4ec40fcebdc3d455ad07861e302c0e1d2660854411edd4d85cb67625fbfd,194,72654535,2576,13.28
122,3d241e478d0088dbe37f69f29176969a1058f160152db9d1060bdaa55c22ce5f,519,6612275,3d241e478d0088dbe37f69f29176969a1058f160152db9d1060bdaa55c22ce5f,519,6605927,6348,12.23
123,749a42c3d1bcb44f5f76e35461ef5bf644cbc71e2841167733dd74c6aa9c3c04,487,2504782,749a42c3d1bcb44f5f76e35461ef5bf644cbc71e2841167733dd74c6aa9c3c04,487,2500000,4782,9.82
124,a7f1eda66d92b9ca7f002ac261d505343d1e9a2c5aa58881175dba1c324ec230,447,806846047,a7f1eda66d92b9ca7f002ac261d505343d1e9a2c5aa58881175dba1c324ec230,447,806840577,5470,12.24
125,ad57e640fe7165061cc6fef64466a10d4ff633400bd897e80d78d8ef5efd9f7e,223,278021,ad57e640fe7165061cc6fef64466a10d4ff633400bd897e80d78d8ef5efd9f7e,223,272691,5330,23.9
126,ac32625388fe866ffef56fb02ea824498d0a6a75615f3c04e6fe0de77ddb8fa0,192,1655600,ac32625388fe866ffef56fb02ea824498d0a6a75615f3c04e6fe0de77ddb8fa0,192,1650988,4612,24.02
127,ddf60a5c65eb4bd2e34697e0aeeb482c37ad3d84bf0459061163e862b69c6766,191,656000,ddf60a5c65eb4bd2e34697e0aeeb482c37ad3d84bf0459061163e862b69c6766,191,623997,32003,167.55
128,23d19a508aceb80816882b67c7962e3c0fa86d16422dc9896e6a0194725a14cd,223,6720277,23d19a508aceb80816882b67c7962e3c0fa86d16422dc9896e6a0194725a14cd,223,6717028,3249,14.57
129,983a8c93641a070bf2b5944245e54298014be4a3ed82f81244f0533f59725d2e,226,1341381,983a8c93641a070bf2b5944245e54298014be4a3ed82f81244f0533f59725d2e,226,1336089,5292,23.42
130,36ba30de1f368d4c79e1b0ce5f69da4515b0204f95547d7853b8b10e84fb48c1,370,2736142,36ba30de1f368d4c79e1b0ce5f69da4515b0204f95547d7853b8b10e84fb48c1,370,2729518,6624,17.9
131,796f640be39feba6b5e59d14731d53e5fb70b332d48d63ad4bda06bc4c4259d5,372,22423738,796f640be39feba6b5e59d14731d53e5fb70b332d48d63ad4bda06bc4c4259d5,372,22418941,4797,12.9
132,b93867e391b56003896410a60228b5b4288933e6a0b2e2daab3886d796874b05,224,8384199,b93867e391b56003896410a60228b5b4288933e6a0b2e2daab3886d796874b05,224,8381299,2900,12.95
133,d592f0bfab59e1fd195f9dbbca2c9e265bf625573e5fa086bb8e0eb9b76721f1,364,16902958,d592f0bfab59e1fd195f9dbbca2c9e265bf625573e5fa086bb8e0eb9b76721f1,364,16896849,6109,16.78
134,4bff4b54cafbb539bf54221f812837187a95f3c3ce5c8e991d978bc593b11963,222,878644,4bff4b54cafbb539bf54221f812837187a95f3c3ce5c8e991d978bc593b11963,222,878080,564,2.54
135,b523cde1a7d1ac2b411a97cd76be2c66083ebe4a05e61ac036d759cc1f91ab04,191,282832565,b523cde1a7d1ac2b411a97cd76be2c66083ebe4a05e61ac036d759cc1f91ab04,191,282669690,162875,852.75
136,01bb20cb7d67f008aa85f098ec2a872c6b0e6f34f376f45f6db9151317269c6a,204,60580,01bb20cb7d67f008aa85f098ec2a872c6b0e6f34f376f45f6db9151317269c6a,204,55940,4640,22.75
137,03ccc77710067d6133fe7a2cb8f52d3af812c4e21576fbfe1747858be784c446,733,176701,03ccc77710067d6133fe7a2cb8f52d3af812c4e21576fbfe1747858be784c446,733,171703,4998,6.82
138,90fabd7fba070c148dd39f30c9a87a4e79a660a4c996e2a37f784035d76ea082,536,4324647,90fabd7fba070c148dd39f30c9a87a4e79a660a4c996e2a37f784035d76ea082,536,4314637,10010,18.68
139,9fd053793a3c96c5ab372ec84e2f29b3505cbb3b378c6a44a2a970b64090356c,448,99207,9fd053793a3c96c5ab372ec84e2f29b3505cbb3b378c6a44a2a970b64090356c,448,95002,4205,9.39
140,28e38e20f86a3ed25d3a4c18a76e5b8141af13624bbd221a206bfd34a7f9b9c2,192,112001,28e38e20f86a3ed25d3a4c18a76e5b8141af13624bbd221a206bfd34a7f9b9c2,192,103735,8266,43.05
141,b7188897a3af2b593187b3eb71bc5a37e2d216651b382cc6af864762058bdd60,372,433719,b7188897a3af2b593187b3eb71bc5a37e2d216651b382cc6af864762058bdd60,372,428935,4784,12.86
142,67b48bccbf81ab215d459287f7f1e6aa09e473ad41799a9c1deec499eef76ee4,804,1036977,67b48bccbf81ab215d459287f7f1e6aa09e473ad41799a9c1deec499eef76ee4,804,1036506,471,0.59
143,bffb7d6c35de14fa4a9c2d4607853af3879a2c4e56d8b355c1ca8f00709ad5d0,191,6461,bffb7d6c35de14fa4a9c2d4607853af3879a2c4e56d8b355c1ca8f00709ad5d0,191,5339,1122,5.87
144,c11dd538e597c5ec9dc42811b6fa109a2794b6665f5e8c4ccdf8adb1d4a2a68c,193,110117,c11dd538e597c5ec9dc42811b6fa109a2794b6665f5e8c4ccdf8adb1d4a2a68c,193,108587,1530,7.93
145,d9c28892168475f3d116f6632bcd81d0591ff1f869e1cc9c634134a3a8b7c27d,191,210679062,d9c28892168475f3d116f6632bcd81d0591ff1f869e1cc9c634134a3a8b7c27d,191,210641810,37252,195.04
146,4d3ff91c5da055c057c53a13402076675bf2d61ab31d89b8711b2178d54dd9b3,225,42883516,4d3ff91c5da055c057c53a13402076675bf2d61ab31d89b8711b2178d54dd9b3,225,42882656,860,3.82
147,62a345d7afa2cc230a6168d4489de20897f470d4c539f4ec8294e303639033e2,192,183700,62a345d7afa2cc230a6168d4489de20897f470d4c539f4ec8294e303639033e2,192,182545,1155,6.02
148,7c1b9b80db9720ecf83bbebf211c9961059573fd5fb6eaac6fea8854ab11d325,191,214513674,7c1b9b80db9720ecf83bbebf211c9961059573fd5fb6eaac6fea8854ab11d325,191,214390293,123381,645.97
149,88eefde48bd236b7652ada0c69b32255b37a5cf0009622ec7fd85882a2b20b16,373,33432,88eefde48bd236b7652ada0c69b32255b37a5cf0009622ec7fd85882a2b20b16,373,30072,3360,9.01
150,c559ccd58968d297da8e2e20492aff3c718d75c67390a789f55088792fb866db,519,527682,c559ccd58968d297da8e2e20492aff3c718d75c67390a789f55088792fb866db,519,524103,3579,6.9
151,78ad6bd836690b6051a93d1833994caae4b245bf4a9b25e0a30a366d25b56bab,222,35472,78ad6bd836690b6051a93d1833994caae4b245bf4a9b25e0a30a366d25b56bab,222,30274,5198,23.41
152,d9498966529a96a05fe30712ec136187452bdfd7a0b79836659466751c2b5d0c,1625,964567050,d9498966529a96a05fe30712ec136187452bdfd7a0b79836659466751c2b5d0c,1625,964545130,21920,13.49
153,de95c88115e6fbe3bbc5b875c4525024d2da8a595178629516f779ba6ce8ffb2,225,1063181,de95c88115e6fbe3bbc5b875c4525024d2da8a595178629516f779ba6ce8ffb2,225,1061021,2160,9.6
154,3a1c1943587d489f9f0d571334cddccf6caea5faa35d2233a30b6cb3c47415b5,223,559865,3a1c1943587d489f9f0d571334cddccf6caea5faa35d2233a30b6cb3c47415b5,223,552729,7136,32
155,a129d5ce267fd392fa01debaff68dceaf9e673a1e7362184745e12d0ad2dd5a8,225,197685,a129d5ce267fd392fa01debaff68dceaf9e673a1e7362184745e12d0ad2dd5a8,225,192241,5444,24.2
156,f19cb42b3747fbdf714758d3e84609f481250022928f876c079e6b96bc476736,9070,90176312,f19cb42b3747fbdf714758d3e84609f481250022928f876c079e6b96bc476736,9070,90021612,154700,17.06
157,09714e912ab6f05adb1bd93e21b960df9717a9aee9e6b9bb3a217a527b5eb5a9,222,200000,09714e912ab6f05adb1bd93e21b960df9717a9aee9e6b9bb3a217a527b5eb5a9,222,193979,6021,27.12
158,2c2327ff9cc332754eef4a808e916de317e0d09375fdfb1c7fc71020237be4ae,964,1599670,2c2327ff9cc332754eef4a808e916de317e0d09375fdfb1c7fc71020237be4ae,964,1588660,11010,11.42
159,2717ab2724783cd98df0bf92883e0bfd52b0f2c8235c861f52e5c0f2f3a50f36,14789,207435129,2717ab2724783cd98df0bf92883e0bfd52b0f2c8235c861f52e5c0f2f3a50f36,14789,207235129,200000,13.52
160,c3b6e14ee09ee11e4d70763782d79ebcf78bbf3542bc631ef42689b969cddbdc,224,771944,c3b6e14ee09ee11e4d70763782d79ebcf78bbf3542bc631ef42689b969cddbdc,224,769419,2525,11.27
161,3aa9a01d8bbe666ec8293a1196c093d51e380db5846cd94a09f0cd94646bcaf5,12873,1494542505,3aa9a01d8bbe666ec8293a1196c093d51e380db5846cd94a09f0cd94646bcaf5,12873,1494358924,183581,14.26
162,7a483d5b95b424165bdc28aea69e6217f6b42146ea75241a8f31a136e3b2a717,258,3734786,7a483d5b95b424165bdc28aea69e6217f6b42146ea75241a8f31a136e3b2a717,258,3732003,2783,10.79
163,bf4460565452d7c0b541b18e53fc8e931e4375a679c190b6e401044e071350b1,340,2320269,bf4460565452d7c0b541b18e53fc8e931e4375a679c190b6e401044e071350b1,340,2316300,3969,11.67
164,f375d411c173ae5af5641fdeb3f0ffdd7bbafc092abc8ec81d943dfcd27ddb6d,222,10755550,f375d411c173ae5af5641fdeb3f0ffdd7bbafc092abc8ec81d943dfcd27ddb6d,222,10754041,1509,6.8
165,990519faf386f2947caf48e284a2b41a3d5101b5ae832b1a62d14c9301f5bd72,336,2825708,990519faf386f2947caf48e284a2b41a3d5101b5ae832b1a62d14c9301f5bd72,336,2806104,19604,58.35
166,c81b88a29be930269aaca3de0319f9407aa4429a4c64d7259d9beeaf36e5d38a,223,4285603,c81b88a29be930269aaca3de0319f9407aa4429a4c64d7259d9beeaf36e5d38a,223,4283413,2190,9.82
167,0c29b7dffa9ec6b04c1e2be259bcdd374a8cab561575fb333cb6430ea0a877e2,1997,52818650,0c29b7dffa9ec6b04c1e2be259bcdd374a8cab561575fb333cb6430ea0a877e2,1997,52769016,49634,24.85
168,43ea440602bcda57555fc9a1013b5aef8136958062918936597f011ab31904ee,343,414085,43ea440602bcda57555fc9a1013b5aef8136958062918936597f011ab31904ee,343,411370,2715,7.92
169,ce21929d4222a9a90fdb7b5cbdb8faf181499adeb288b50dcf19eec4e0ca6d0d,191,166561615,ce21929d4222a9a90fdb7b5cbdb8faf181499adeb288b50dcf19eec4e0ca6d0d,191,166488353,73262,383.57
170,f804d3b0b0e1b84cb8db1290a607868cf96096d767a9da2083323e0ea7f0dd86,188,88863,f804d3b0b0e1b84cb8db1290a607868cf96096d767a9da2083323e0ea7f0dd86,188,86179,2684,14.28
171,55781dbb016ee35a0a560e0861eeae7625ac54bb569fd5cc476a9939bfe6d62b,371,31888,55781dbb016ee35a0a560e0861eeae7625ac54bb569fd5cc476a9939bfe6d62b,371,29641,2247,6.06
172,6b2ecbfec94b326433b9cd50adbd4c86e1a99ba67f999d67d4bf2ae30983fbb8,191,73189,6b2ecbfec94b326433b9cd50adbd4c86e1a99ba67f999d67d4bf2ae30983fbb8,191,71659,1530,8.01
173,c679481bf95a6ca1d9026cdc6f6466f89632bb62e2640a085f450518342e1cb3,1818,32198825,c679481bf95a6ca1d9026cdc6f6466f89632bb62e2640a085f450518342e1cb3,1818,32174149,24676,13.57
174,e120ae0ea77c7179aa7daf09a2a7362a880ed2ca311cf11b9a55d5989fde5a97,226,12409,e120ae0ea77c7179aa7daf09a2a7362a880ed2ca311cf11b9a55d5989fde5a97,226,10249,2160,9.56
175,478e9009924a1ac04ec03208e5f2bee166d1c2f5aaede832df6e7ebdc2764e90,225,325363148,478e9009924a1ac04ec03208e5f2bee166d1c2f5aaede832df6e7ebdc2764e90,225,325359116,4032,17.92
176,d1158eb5dddf180fb4a4ab2cff8f81a1b046e6927dfa0b1e5f9a882498361948,226,178620,d1158eb5dddf180fb4a4ab2cff8f81a1b046e6927dfa0b1e5f9a882498361948,226,176764,1856,8.21
177,d75db3be6bf095887c5fbdf2db76ce2c105103509258956b2c39b93db38e31bc,344,2137772,d75db3be6bf095887c5fbdf2db76ce2c105103509258956b2c39b93db38e31bc,344,2132928,4844,14.08
178,12bb3b7e2341bd54bf5089a225761928166a91c3cd81eff235fd4933925b4473,646,3348030,12bb3b7e2341bd54bf5089a225761928166a91c3cd81eff235fd4933925b4473,646,3332683,15347,23.76
179,3424f9cd0236afb040bf6508172c445605dce4013c429cec5c0730b9da67a45b,780,590342,3424f9cd0236afb040bf6508172c445605dce4013c429cec5c0730b9da67a45b,780,581718,8624,11.06
180,fe409b36e857d52d48ac00d963ba9ae5c98c636cc173232700d84d17d0dc2bef,222,107885633,fe409b36e857d52d48ac00d963ba9ae5c98c636cc173232700d84d17d0dc2bef,222,107883630,2003,9.02
181,0e8ca7573cb81a7462eddbe0a2eeceea16874e62849fce2ef7104b875f08136a,222,2943308,0e8ca7573cb81a7462eddbe0a2eeceea16874e62849fce2ef7104b875f08136a,222,2940222,3086,13.9
182,4a6b2a51a3781f250334c6ffc061879dfe93984037f697a6a0e61b781cb3eb11,8919,119311020,4a6b2a51a3781f250334c6ffc061879dfe93984037f697a6a0e61b781cb3eb11,8919,119191996,119024,13.34
183,955d979b2cc125bfac9df4c8c7da0fe670df0843554ac095ae19a081ce3f87c5,193,132250,955d979b2cc125bfac9df4c8c7da0fe670df0843554ac095ae19a081ce3f87c5,193,129007,3243,16.8
184,e1d895e3797e8083cd63f4fde9adeb3380d24adda4787415f96ff4281345fca9,422,9192866,e1d895e3797e8083cd63f4fde9adeb3380d24adda4787415f96ff4281345fca9,422,9189405,3461,8.2
185,87baa71e1930f2645e107f35f0bbf3f52101f0ccd7693d7a2f79da4299835f9c,256,64176218,87baa71e1930f2645e107f35f0bbf3f52101f0ccd7693d7a2f79da4299835f9c,256,64149137,27081,105.79
186,120d8b7d9580e06d905369d6cf84e7d7ac7d3994652c4e9269684fc99527d69d,225,8163943829,120d8b7d9580e06d905369d6cf84e7d7ac7d3994652c4e9269684fc99527d69d,225,8163941765,2064,9.17
187,a40c8f2e9b15cd9f5c8d7f1bc15930dad81e6bf5c5091456aec9a62974cc4387,466,235657,a40c8f2e9b15cd9f5c8d7f1bc15930dad81e6bf5c5091456aec9a62974cc4387,466,235318,339,0.73
188,1af7d87bced80017136af23d76bfa482b0fca9a1f992d4bd4a087f4cce0f7f76,223,2470845,1af7d87bced80017136af23d76bfa482b0fca9a1f992d4bd4a087f4cce0f7f76,223,2465663,5182,23.24
189,69847477cd508d1b17e8bdbca8ab40a8aeb878ff5e443f1d712edc776787855c,371,4783884,69847477cd508d1b17e8bdbca8ab40a8aeb878ff5e443f1d712edc776787855c,371,4780749,3135,8.45
190,2ba08ace46ac528a1a37cbc3945e048f25fd3f4f38e33171d0e64ec9434717d3,223,9778464,2ba08ace46ac528a1a37cbc3945e048f25fd3f4f38e33171d0e64ec9434717d3,223,9776420,2044,9.17
191,7eb2ae236fd118fccaa016d646c79ab9fed1fc9f906e4c100fa4f333be71074f,224,667324,7eb2ae236fd118fccaa016d646c79ab9fed1fc9f906e4c100fa4f333be71074f,224,665194,2130,9.51
192,c3f289ffb360ed93f79115a780a19969fa51228faae1886bc9dbba1c0f843e6d,223,14073412,c3f289ffb360ed93f79115a780a19969fa51228faae1886bc9dbba1c0f843e6d,223,14070474,2938,13.17
193,4b01a080fca963acae1f10cfdf4db4accd3feed7229077c066fa0a8e3fcee7ef,223,76228,4b01a080fca963acae1f10cfdf4db4accd3feed7229077c066fa0a8e3fcee7ef,223,73013,3215,14.42
194,5d3f24a420456df2d38dc5729014042e52fe5ab86adfc886031984ede0a39287,386,217423,5d3f24a420456df2d38dc5729014042e52fe5ab86adfc886031984ede0a39287,386,214225,3198,8.28
195,0e3e5bb6769efd1ef99e4bf8ebf3e1cccdb5a2ffd63730d278591c5ef1e0bd05,191,198229239,0e3e5bb6769efd1ef99e4bf8ebf3e1cccdb5a2ffd63730d278591c5ef1e0bd05,191,198194067,35172,184.15
196,7870f9f3bf13eb6a3563c23c18d9d3d99449966aac5ccb04c7afb9190dbadd21,234,974233,7870f9f3bf13eb6a3563c23c18d9d3d99449966aac5ccb04c7afb9190dbadd21,234,970304,3929,16.79
197,e6db0101d09f343266d8864f885b559941c90743fa543fc567960e04b7d76438,222,69151056,e6db0101d09f343266d8864f885b559941c90743fa543fc567960e04b7d76438,222,69147249,3807,17.15
198,20187ceea750d926ca7512b407451ce155be613f76d3a8933da8b2e722606c2d,8924,75407631,20187ceea750d926ca7512b407451ce155be613f76d3a8933da8b2e722606c2d,8924,75255447,152184,17.05
199,5351d3c905611521da75081127893fb19f139e90fada936c6757554b181effb1,151,499000,5351d3c905611521da75081127893fb19f139e90fada936c6757554b181effb1,151,497800,1200,7.95
200,607482851bc03ef6743570a117bd5a71c851a3f7ae38570d19f909537ec509b8,191,5600046,607482851bc03ef6743570a117bd5a71c851a3f7ae38570d19f909537ec509b8,191,5595562,4484,23.48
201,986c0c8a2e65c78375812352d9605510493fae91fda14aa728e911d3bcb603ce,225,2487022,986c0c8a2e65c78375812352d9605510493fae91fda14aa728e911d3bcb603ce,225,2442382,44640,198.4
202,a41b227c72bd0f8a9db7a9f53bf0ed1363b8d761707459e5fced67e08e741930,371,5232949,a41b227c72bd0f8a9db7a9f53bf0ed1363b8d761707459e5fced67e08e741930,371,5228175,4774,12.87
203,1541a3518ec5b58762447bdc0aa8f70a32e75a659c478360f6b30939c5cfc2e0,222,2025473,1541a3518ec5b58762447bdc0aa8f70a32e75a659c478360f6b30939c5cfc2e0,222,2023900,1573,7.09
204,9a747860f9e7207922d23a8b3c4daaabaecab81aa88801ec36b320c6ee229433,247,300127,9a747860f9e7207922d23a8b3c4daaabaecab81aa88801ec36b320c6ee229433,247,298181,1946,7.88
205,e9eb1582002713bdfe14a927001e92a4dba60fa7f10d2210ad666623d5e15353,407,5707,e9eb1582002713bdfe14a927001e92a4dba60fa7f10d2210ad666623d5e15353,407,5000,707,1.74
206,898ac6ba022d7e2f22316c444082db50a6fe611a859f128dbbb3d618eb53d477,225,20000000,898ac6ba022d7e2f22316c444082db50a6fe611a859f128dbbb3d618eb53d477,225,19997940,2060,9.16
207,f962a191dcdd09b6f53ec5446016f2265d49685215c774c9af88d53de089ed66,225,4626323,f962a191dcdd09b6f53ec5446016f2265d49685215c774c9af88d53de089ed66,225,4624738,1585,7.04
208,536b8dd4fddf0e53041a2483a23b6db47926a0e61eee697fb6e9a295229d6614,223,1924923,536b8dd4fddf0e53041a2483a23b6db47926a0e61eee697fb6e9a295229d6614,223,1919593,5330,23.9
209,e6774e163e4a0a7c8faee3c35e38bf2634dfaa22a877af899f1088e2576ccefd,191,252050814,e6774e163e4a0a7c8faee3c35e38bf2634dfaa22a877af899f1088e2576ccefd,191,251899059,151755,794.53
210,3aa1bcf0e9f40d450674f45672983d3cecc32da4ab4fea4ee622afaabdff9adb,223,623143,3aa1bcf0e9f40d450674f45672983d3cecc32da4ab4fea4ee622afaabdff9adb,223,621326,1817,8.15
211,74567e31f384a6c8ae000e7839e0d71960a7eccf825d79b365c670d95be6a18e,225,42629218,74567e31f384a6c8ae000e7839e0d71960a7eccf825d79b365c670d95be6a18e,225,42626050,3168,14.08
212,945bfee36667baab8fbe6760af6506e7e7fea71ce4b3b468bfa5e0ec365a38ce,222,230384,945bfee36667baab8fbe6760af6506e7e7fea71ce4b3b468bfa5e0ec365a38ce,222,230036,348,1.57
213,318d7be0c0ae253891f0faaed4eb80f4b9d2e2d4f22c768d5ae43f95442df047,511,160498,318d7be0c0ae253891f0faaed4eb80f4b9d2e2d4f22c768d5ae43f95442df047,511,154629,5869,11.49
214,6b316c779d38eae4c6b9489f51b0de3cc460857716f28a3e82eddc1e627e25ea,191,617484,6b316c779d38eae4c6b9489f51b0de3cc460857716f28a3e82eddc1e627e25ea,191,616978,506,2.65
215,ab41f7b75e72503db9241681a82ec27b9e34639ca9337190ad854cbd4dee9eea,225,6892144,ab41f7b75e72503db9241681a82ec27b9e34639ca9337190ad854cbd4dee9eea,225,6886946,5198,23.1
216,bcc0c4861ccff8648f0cdf7fcf4ca64dcd25ab3458d6b23a58b6725c859cbe50,191,150565755,bcc0c4861ccff8648f0cdf7fcf4ca64dcd25ab3458d6b23a58b6725c859cbe50,191,150544836,20919,109.52
217,d4c86ee8aed42f0e246e716da5eab81d5e3cef5dd1018217c87767eb6a6dfdd8,247,712275,d4c86ee8aed42f0e246e716da5eab81d5e3cef5dd1018217c87767eb6a6dfdd8,247,709685,2590,10.49
218,037a713aa3a2b645090222171abbed517ded3719e35c4faf1ee0b242237ed5b3,223,80522,037a713aa3a2b645090222171abbed517ded3719e35c4faf1ee0b242237ed5b3,223,76070,4452,19.96
219,accd665939ccd55088c09a8240a401727ae6e58578a81a9c3fa72b19c56a229a,8921,68394501,accd665939ccd55088c09a8240a401727ae6e58578a81a9c3fa72b19c56a229a,8921,68284545,109956,12.33
220,ebfa39a2498b32aae485cda87528fbf2ecdc0518740e30d6142d6b9f10c974cc,222,38881522,ebfa39a2498b32aae485cda87528fbf2ecdc0518740e30d6142d6b9f10c974cc,222,38876522,5000,22.52
221,108d8631f1ab316f27d05d71347b194ff380cdc70577f7bbbaef1a62d2e73f97,191,187061952,108d8631f1ab316f27d05d71347b194ff380cdc70577f7bbbaef1a62d2e73f97,191,186986611,75341,394.46
222,22fc943aaf6a3e78c52bce96d22dfee9ac279cdded4eb110c1b6c4f54b41a152,234,977402,22fc943aaf6a3e78c52bce96d22dfee9ac279cdded4eb110c1b6c4f54b41a152,234,973473,3929,16.79
223,9541d93e75ac9511da8f8026d35813057f9e3cda41e34c22b96ddac7d1e77c26,223,31560012,9541d93e75ac9511da8f8026d35813057f9e3cda41e34c22b96ddac7d1e77c26,223,31557820,2192,9.83
224,d8459cfbfac472f0fdc2da8458716d08ba6a43a6dc4bf2d05dadd327702b75e3,223,360247,d8459cfbfac472f0fdc2da8458716d08ba6a43a6dc4bf2d05dadd327702b75e3,223,358417,1830,8.21
225,559a44ab0fa6ae597b0971598e1b315d8bed09ea211e0b358f0ca984a26420bb,14791,149035725,559a44ab0fa6ae597b0971598e1b315d8bed09ea211e0b358f0ca984a26420bb,14791,148835725,200000,13.52
226,f312401a577d4fe7e8931b504775a19c558fbb750e4b68143f7b04f08e9c4f12,222,4378825,f312401a577d4fe7e8931b504775a19c558fbb750e4b68143f7b04f08e9c4f12,222,4374172,4653,20.96
227,2fef14855a69163b8f9dba6d189fbbffb2b48cec1e8bdef3aa485c00a7ac08e2,223,4258292,2fef14855a69163b8f9dba6d189fbbffb2b48cec1e8bdef3aa485c00a7ac08e2,223,4252962,5330,23.9
228,35f14aa5a18677759246843bc850b10ed91ddb4f21e9c7eb9dac7f6ec4936033,341,18874368,35f14aa5a18677759246843bc850b10ed91ddb4f21e9c7eb9dac7f6ec4936033,341,18870781,3587,10.52
229,5fd9ac020bb21b0f49d57676b6fc630ecb9051f1bf0fda7ed842577ae144af0f,424,1946599,5fd9ac020bb21b0f49d57676b6fc630ecb9051f1bf0fda7ed842577ae144af0f,424,1939356,7243,17.08
230,dca079479a7dd3277b41a97d32d89201b5796a3edf3184511126bee627f07d52,369,5445008,dca079479a7dd3277b41a97d32d89201b5796a3edf3184511126bee627f07d52,369,5434991,10017,27.15
231,6b3cd17b42a7d7c6041a13992b06e101c1dff2f7eddf9d2be0d76ba7ab184232,224,196762607,6b3cd17b42a7d7c6041a13992b06e101c1dff2f7eddf9d2be0d76ba7ab184232,224,196760857,1750,7.81
232,fbba553cc73f8c82465ea1a75047583fab5e87499daec266c28cd09faec2b4a7,191,434698,fbba553cc73f8c82465ea1a75047583fab5e87499daec266c28cd09faec2b4a7,191,430495,4203,22.01
233,cc9d7ea49677866fe320a54ad0d0506b81b94b39e1d5d7b30ab6fa498dfe9541,192,412000,cc9d7ea49677866fe320a54ad0d0506b81b94b39e1d5d7b30ab6fa498dfe9541,192,365706,46294,241.11
234,8bfdfeace51763bbfb217f9102adb137cfebdcbdd829c266c17692392c461a37,192,29000,8bfdfeace51763bbfb217f9102adb137cfebdcbdd829c266c17692392c461a37,192,27500,1500,7.81
235,b1dfbc06da21e710c3e643b1c90c99a8b6688c662ab13bb07d84733076071177,162,7558,b1dfbc06da21e710c3e643b1c90c99a8b6688c662ab13bb07d84733076071177,162,4938,2620,16.17
236,09f576795faf7862bfbeef8a16b9a99e3af691a22ed8edff2673e8619a7a6b85,373,118854,09f576795faf7862bfbeef8a16b9a99e3af691a22ed8edff2673e8619a7a6b85,373,110916,7938,21.28
237,e5b561dd9238762383e925ec14c47a8150f202da72f4c5c49f35a06b85c5003c,222,1475239,e5b561dd9238762383e925ec14c47a8150f202da72f4c5c49f35a06b85c5003c,222,1472522,2717,12.24
238,18aa8c927535117ac9cfe2c24baf94426d18aad7ccdf7cd078fac23c0ee2fbef,371,23440916,18aa8c927535117ac9cfe2c24baf94426d18aad7ccdf7cd078fac23c0ee2fbef,371,23437651,3265,8.8
239,74f42b0809c1b8d41855195d676037b79c5f05c4581be459cbf051c1df782951,191,164506290,74f42b0809c1b8d41855195d676037b79c5f05c4581be459cbf051c1df782951,191,164482630,23660,123.87
240,a3bcec3bf4e8b9dac92edd936c4689e02461eb6ca696a500c1fa42e5a171925c,223,16314500,a3bcec3bf4e8b9dac92edd936c4689e02461eb6ca696a500c1fa42e5a171925c,223,16312400,2100,9.42
241,d837b25d002fb74e38d08c74d6fe9a1768596ac405219101ba921c952d4fd147,14792,214522414,d837b25d002fb74e38d08c74d6fe9a1768596ac405219101ba921c952d4fd147,14792,214322414,200000,13.52
242,3d986b25a6ec6410c4665002e655239b1cd36f3d416630489938d562bae7c649,191,247806319,3d986b25a6ec6410c4665002e655239b1cd36f3d416630489938d562bae7c649,191,247762367,43952,230.12
243,924dfbbfd20b7546d17e4b11ec878cf9053948300e1dc66d6436a4c220150e72,216,179993,924dfbbfd20b7546d17e4b11ec878cf9053948300e1dc66d6436a4c220150e72,216,176928,3065,14.19
244,ad1785a647a167170d6cf950b18a0c184fdedf355f71effe2a3a8858a33f22d4,374,3627747,ad1785a647a167170d6cf950b18a0c184fdedf355f71effe2a3a8858a33f22d4,374,3625010,2737,7.32
245,ce72c5bdd21e815079274ab48726f655989474007c44d883da27eb1caedbcbc2,373,1969300,ce72c5bdd21e815079274ab48726f655989474007c44d883da27eb1caedbcbc2,373,1961840,7460,20
246,d0e4a3cd2129d294f673f0f89c331abfd07a3ae854e0926487b0603150b00694,963,52516562,d0e4a3cd2129d294f673f0f89c331abfd07a3ae854e0926487b0603150b00694,963,52492462,24100,25.03
247,37c6c1b3a5b344c7a26d4472c9ad7a6de32a8922d871e08f256ee180ef345ca9,191,261911577,37c6c1b3a5b344c7a26d4472c9ad7a6de32a8922d871e08f256ee180ef345ca9,191,261748382,163195,854.42
248,858462de04bc07361c33357a446bd58d134fb8831e0f080a196de97c104dcbec,260,207162212,858462de04bc07361c33357a446bd58d134fb8831e0f080a196de97c104dcbec,260,207161100,1112,4.28
249,cbe571b059bb5e7ed48d7796a6393a054096ad9504c1a7c9853ac27725f4e093,225,929100,cbe571b059bb5e7ed48d7796a6393a054096ad9504c1a7c9853ac27725f4e093,225,928524,576,2.56
250,297ff3a52edbac9ba23623fc72048f502dcefb0ab8ce552cd21a610209af2124,222,1313573214,297ff3a52edbac9ba23623fc72048f502dcefb0ab8ce552cd21a610209af2124,222,1313571488,1726,7.77
251,2d97663e0a7118bcc989b0f12663d1ac68fc5eff6175901db55c1f8cb12d976b,14790,226015711,2d97663e0a7118bcc989b0f12663d1ac68fc5eff6175901db55c1f8cb12d976b,14790,225815711,200000,13.52
252,8190507bb4dbb5661b368fabb7b3e0b18be898c469d5bd38ba76223abe284687,234,975516,8190507bb4dbb5661b368fabb7b3e0b18be898c469d5bd38ba76223abe284687,234,971587,3929,16.79
253,c3258339f76e97ec5f22de385c7b6d1defa3663718ce2a0307740717e36fc24b,370,1552692,c3258339f76e97ec5f22de385c7b6d1defa3663718ce2a0307740717e36fc24b,370,1544791,7901,21.35
254,5e60a4de2f23ec50b2b89dd199eafa2d6c54c2ce85ec1086e9625f3f5ee9f8b3,221,184173,5e60a4de2f23ec50b2b89dd199eafa2d6c54c2ce85ec1086e9625f3f5ee9f8b3,221,179993,4180,18.91
255,c815a9e60202c8e299ea360aa098dd5479e14418f6cdb0ae5b0841105f5f709f,413,3622008,c815a9e60202c8e299ea360aa098dd5479e14418f6cdb0ae5b0841105f5f709f,413,3619441,2567,6.22
256,1cf4b3dea1e221b75f48ae444045750515fa90a466e912b826c2af3d3db59cfe,223,78519,1cf4b3dea1e221b75f48ae444045750515fa90a466e912b826c2af3d3db59cfe,223,76793,1726,7.74
257,fd8bdc2b8cb4036e897f2739cc4ffe8c6ed89afa54422bc70bfa0742c9598beb,191,168620179,fd8bdc2b8cb4036e897f2739cc4ffe8c6ed89afa54422bc70bfa0742c9598beb,191,168587255,32924,172.38
258,3e72deb4c34605030f6ff4066577445160f2874980228da1376bfff042cd46f6,225,6626045,3e72deb4c34605030f6ff4066577445160f2874980228da1376bfff042cd46f6,225,6622825,3220,14.31
259,886eef5b2f236864f8de4d082a320af2ebfeb74952d8ca28e535db2f2bbf1aa2,225,904782,886eef5b2f236864f8de4d082a320af2ebfeb74952d8ca28e535db2f2bbf1aa2,225,901710,3072,13.65
260,0823a107a39a8bf302a09a2abf6031f3f235b9c45876625aa2516c607ad43b40,14790,376683180,0823a107a39a8bf302a09a2abf6031f3f235b9c45876625aa2516c607ad43b40,14790,376483180,200000,13.52
261,8d5cc16df680df61d38d84144030e89038cbed4772ced72d95d1767663638985,193,3359922,8d5cc16df680df61d38d84144030e89038cbed4772ced72d95d1767663638985,193,3357386,2536,13.14
262,a774565577331ec5dcbad1b483d965d6b67afd3a4ef26bca0f87f7fcafb068ef,14800,219211061,a774565577331ec5dcbad1b483d965d6b67afd3a4ef26bca0f87f7fcafb068ef,14800,219011061,200000,13.51
263,ad76ee46dde5a80277d9fa96d7825306332b9fdfc9fa1f0906b0bbe85bccb507,373,3310897,ad76ee46dde5a80277d9fa96d7825306332b9fdfc9fa1f0906b0bbe85bccb507,373,3304061,6836,18.33
264,0b692a73863433250e3bdc12db3d69f9550df8f052b4dcdd629febc8f744b95b,341,36212661,0b692a73863433250e3bdc12db3d69f9550df8f052b4dcdd629febc8f744b95b,341,36209637,3024,8.87
265,3a57b2f9d32bcf80667b03d2a626955989f595f23a18efff311bb480a323ce39,193,1333,3a57b2f9d32bcf80667b03d2a626955989f595f23a18efff311bb480a323ce39,193,600,733,3.8
266,cccd0b21c3ac878dcfc063ebebb6d93f23760afe276ec81cd0e89bae53948e5c,825,66186245,cccd0b21c3ac878dcfc063ebebb6d93f23760afe276ec81cd0e89bae53948e5c,825,66172871,13374,16.21
267,1b250bc5e48e15eb2c51461e35b9e9e16cf94e93acbb108e3bab59365468efad,226,434764682,1b250bc5e48e15eb2c51461e35b9e9e16cf94e93acbb108e3bab59365468efad,226,434757902,6780,30
268,292439249dc99233065eb9cf8a3d7cc2dc678955edcf0f9a7673d40b8184119d,222,6452822,292439249dc99233065eb9cf8a3d7cc2dc678955edcf0f9a7673d40b8184119d,222,6450566,2256,10.16
269,46cb1c920ccbb70cad62e4c7f0c0cc1f813a14629e7b3c283dbb15128de962fd,193,479873,46cb1c920ccbb70cad62e4c7f0c0cc1f813a14629e7b3c283dbb15128de962fd,193,478208,1665,8.63
270,e2b990cb24bcf2dc58dee64e6b10f36f0e5a100a795dc9399b3e873568014391,223,1357710,e2b990cb24bcf2dc58dee64e6b10f36f0e5a100a795dc9399b3e873568014391,223,1350351,7359,33
271,0325ec2a281eb7243da3499731cb1893274b9fdccdcf7ff36309d40dd0d674cf,226,413079,0325ec2a281eb7243da3499731cb1893274b9fdccdcf7ff36309d40dd0d674cf,226,410919,2160,9.56
272,70fb7d974d42d774eb7c0759f1f48fe71108c6dc99fdf5c88f5b52780437ecd9,1367,1000719,70fb7d974d42d774eb7c0759f1f48fe71108c6dc99fdf5c88f5b52780437ecd9,1367,992228,8491,6.21
273,cf61323a77dbff53b6bc0c17ef11df4d964e2ae9a3288fed69af3fc449928b55,191,171149115,cf61323a77dbff53b6bc0c17ef11df4d964e2ae9a3288fed69af3fc449928b55,191,171125234,23881,125.03
274,04c8976157dcc3eedb4fea9c7bba8357776f871634864d8cdade5a31acb9bee1,222,5000000,04c8976157dcc3eedb4fea9c7bba8357776f871634864d8cdade5a31acb9bee1,222,4997260,2740,12.34
275,4d6da7f3893c59e2cad11d8f9066a29223031a4965776f986c5ab7208107f02d,373,1020340,4d6da7f3893c59e2cad11d8f9066a29223031a4965776f986c5ab7208107f02d,373,1012402,7938,21.28
276,525a877b287de26fd3f8ea6f6e7ba6fa4c9ec098b55f11244a59c9d0289f588d,223,27224123,525a877b287de26fd3f8ea6f6e7ba6fa4c9ec098b55f11244a59c9d0289f588d,223,27221383,2740,12.29
277,94812a7bba18e2582cac7272058f207557fe416fbfb81bffde069ef8175c4fa7,222,2353,94812a7bba18e2582cac7272058f207557fe416fbfb81bffde069ef8175c4fa7,222,1926,427,1.92
278,43e0e38e7f0e008a679ae348bdbbc6cd119622696e31765f86ea95142906c9a2,194,58217,43e0e38e7f0e008a679ae348bdbbc6cd119622696e31765f86ea95142906c9a2,194,56219,1998,10.3
279,e43b7c5e91526e82d1968b88737e6547ca62c036f302299755720556772c3533,223,93714220,e43b7c5e91526e82d1968b88737e6547ca62c036f302299755720556772c3533,223,93710220,4000,17.94
280,ea2a9ec7238d07b1650a3ea5e86ed23136d8030077dc0975a6f86c3835929dca,8923,216099880,ea2a9ec7238d07b1650a3ea5e86ed23136d8030077dc0975a6f86c3835929dca,8923,215947696,152184,17.06
281,976ddd30d59864d38adbdb141880b9588ae1ac8604f319417d2eacfb8ed65f84,192,1612195,976ddd30d59864d38adbdb141880b9588ae1ac8604f319417d2eacfb8ed65f84,192,1609632,2563,13.35
282,e4bea52dc5da2adb946fb93231575b8888d4f32775662c3be9fc729d24068641,349,6026247,e4bea52dc5da2adb946fb93231575b8888d4f32775662c3be9fc729d24068641,349,6020873,5374,15.4
283,5257a2de520bcee07e9335d4e7a350baacb52206dd7abf9c5d9a835cdf6291fa,225,1692940,5257a2de520bcee07e9335d4e7a350baacb52206dd7abf9c5d9a835cdf6291fa,225,1689720,3220,14.31
284,832c7338414dcc9157f82083306e117f504005788baeed3b00f9e5dc54ab0ae2,8445,304436291,832c7338414dcc9157f82083306e117f504005788baeed3b00f9e5dc54ab0ae2,8445,304315798,120493,14.27
285,a4ddda763cb2d557d2b979ab66589fc9a77a6a9ca1a3413a6c857961c2fcc9e4,225,944437,a4ddda763cb2d557d2b979ab66589fc9a77a6a9ca1a3413a6c857961c2fcc9e4,225,942581,1856,8.25
286,027dc22f63df8f81668689586eac86ef18efd7e099b291f45f73062ea4a02c87,191,232060720,027dc22f63df8f81668689586eac86ef18efd7e099b291f45f73062ea4a02c87,191,231963346,97374,509.81
287,0d62bc0c44957fa07426419c7d8fb92d21c39244347330132d014c5bc289f841,193,342500,0d62bc0c44957fa07426419c7d8fb92d21c39244347330132d014c5bc289f841,193,337888,4612,23.9
288,28af2e0037ce5f825eb02f245ad123b1fb1428cfbd9c845bd73d1af7d119feff,14796,768610162,28af2e0037ce5f825eb02f245ad123b1fb1428cfbd9c845bd73d1af7d119feff,14796,768410162,200000,13.52
289,42f33756476e856aae68e75208245269594e9533b7d26bb3afddfc30b0f5569d,222,404879061,42f33756476e856aae68e75208245269594e9533b7d26bb3afddfc30b0f5569d,222,404875254,3807,17.15
290,65f58bbd831f9f49df966f9749ea712f89c5255af54d5e06159f1b783bffdade,222,67230079,65f58bbd831f9f49df966f9749ea712f89c5255af54d5e06159f1b783bffdade,222,67227986,2093,9.43
291,95c2db961c94d1be32b30cb1bc9744ee810892edfc928ce8f6be764ad883f530,191,259163197,95c2db961c94d1be32b30cb1bc9744ee810892edfc928ce8f6be764ad883f530,191,259073062,90135,471.91
292,ee11982118137365a7d2a2649742e84f150ecd6b7e88c31cba904d80a8d06260,341,1306414,ee11982118137365a7d2a2649742e84f150ecd6b7e88c31cba904d80a8d06260,341,1304096,2318,6.8
293,0d4f20cc2c338b64ba9945e36a3a3fb9998061e5845f3e570e8194676c24187e,223,5243419,0d4f20cc2c338b64ba9945e36a3a3fb9998061e5845f3e570e8194676c24187e,223,5240204,3215,14.42
294,871de05fbd2e7fc2c717c77c3b563b11ae2924305e6a0fce3f1defbd57d224d2,285,19866001,871de05fbd2e7fc2c717c77c3b563b11ae2924305e6a0fce3f1defbd57d224d2,285,19855800,10201,35.79
295,d5ac26d87db56d243f1794c0fb902ffe4acd86033c514b369e93cb9fee2f7d6f,191,119462582,d5ac26d87db56d243f1794c0fb902ffe4acd86033c514b369e93cb9fee2f7d6f,191,119328076,134506,704.22
296,e273945111d4b4d3d960fcc743655ec51ac72d6e837081d044f34adba9a9d98e,191,7299392,e273945111d4b4d3d960fcc743655ec51ac72d6e837081d044f34adba9a9d98e,191,7293204,6188,32.4
297,2157bea550b9495a5f0e11cfefbde7457b2a0514f17505525f4d0d8563f45a80,255,1158540,2157bea550b9495a5f0e11cfefbde7457b2a0514f17505525f4d0d8563f45a80,255,1157988,552,2.16
298,29347f4bea8304cdb5c1aea3beb3045e93e71da8288f88a0ef8d435d1d0a6208,418,1591616,29347f4bea8304cdb5c1aea3beb3045e93e71da8288f88a0ef8d435d1d0a6208,418,1585739,5877,14.06
299,b7ee359598c4a02d9855c150faa449d9fc7c086174b398c9083e56ef3c31a2d6,191,1744631,b7ee359598c4a02d9855c150faa449d9fc7c086174b398c9083e56ef3c31a2d6,191,1734760,9871,51.68
300,6ac5e9a4a6d54df6b1543721f15fe46611d4bd042572c6e379f44d84be93d6c1,374,47011755,6ac5e9a4a6d54df6b1543721f15fe46611d4bd042572c6e379f44d84be93d6c1,374,47006912,4843,12.95
301,4489fc9bfede8731fe49163fc1dc86e45a66c4ba4495a168862b835edc38cc09,370,1412448,4489fc9bfede8731fe49163fc1dc86e45a66c4ba4495a168862b835edc38cc09,370,1408684,3764,10.17
302,5d95d144116a434ac1f0764a6d73d9b0c968e0486e9b3eeafb1498a704a33f4a,370,1001368,5d95d144116a434ac1f0764a6d73d9b0c968e0486e9b3eeafb1498a704a33f4a,370,998024,3344,9.04
303,2daf10137bac1718d94fa2f6e28f2d799866a6dbf7f944533383a376cbc81e75,533,329313,2daf10137bac1718d94fa2f6e28f2d799866a6dbf7f944533383a376cbc81e75,533,325491,3822,7.17
304,be89499706958b704f9f14b4f861e192b4b23ea8f17e004b3185d73dfe501a3e,222,6063000,be89499706958b704f9f14b4f861e192b4b23ea8f17e004b3185d73dfe501a3e,222,6060260,2740,12.34
305,68f88f6e2a10176ee23bf8e7407ac2b91302a65b121afc5f213b3fe1b82ae4c0,222,1532148,68f88f6e2a10176ee23bf8e7407ac2b91302a65b121afc5f213b3fe1b82ae4c0,222,1529502,2646,11.92
306,b9f88c63ab45cf8c2c98f912833ab64dd981067a8190c1b53122ba7e62a9332b,224,992785,b9f88c63ab45cf8c2c98f912833ab64dd981067a8190c1b53122ba7e62a9332b,224,987566,5219,23.3
307,0458e4b94e856c9d706114be79dcbea8d753232a53372fa020484fcd0573c90b,226,41084487,0458e4b94e856c9d706114be79dcbea8d753232a53372fa020484fcd0573c90b,226,41081278,3209,14.2
308,0c60eb0663efc9941c265d7c1fa3a41cb3a62255b07b6d62b02c8345518251a5,691,69389445,0c60eb0663efc9941c265d7c1fa3a41cb3a62255b07b6d62b02c8345518251a5,691,69372480,16965,24.55
309,46f8c485972d06b9d98508a5d1eb007d9e20a7c4079e84d03ced10e37acb5209,225,14145608,46f8c485972d06b9d98508a5d1eb007d9e20a7c4079e84d03ced10e37acb5209,225,14144746,862,3.83
310,94e37c403844ece2d125220027f59de521ca5f120940d9460a766d46ca6f3ddf,191,196410689,94e37c403844ece2d125220027f59de521ca5f120940d9460a766d46ca6f3ddf,191,196340721,69968,366.32
311,9c30725f7f871e35c72604afa09fd6589fc4b05375870bc42d6b5754f5826848,215,200585783,9c30725f7f871e35c72604afa09fd6589fc4b05375870bc42d6b5754f5826848,215,200575600,10183,47.36
312,2715188c2299a760440758a021b7becf8e101ca488a44f25874c815f8621279d,223,3466448,2715188c2299a760440758a021b7becf8e101ca488a44f25874c815f8621279d,223,3461266,5182,23.24
313,92815147a6666bb46b646e0e5911c3360dfa438f067af1fb7e508831d1400a12,340,510788,92815147a6666bb46b646e0e5911c3360dfa438f067af1fb7e508831d1400a12,340,503606,7182,21.12
314,ba9961d8ddaccba6bc308a25a1e0f50fd5b85efc39b2a5f105eb34b5cf571188,223,1799391,ba9961d8ddaccba6bc308a25a1e0f50fd5b85efc39b2a5f105eb34b5cf571188,223,1793617,5774,25.89
315,44bb403a9713ec695a9cfdbd54ea0a43371bd6c5f3485df39285a738bf8c2a0a,224,576825,44bb403a9713ec695a9cfdbd54ea0a43371bd6c5f3485df39285a738bf8c2a0a,224,573985,2840,12.68
316,5341f4b3a955c8c6a95a0c64736c700b585848d1973b3280e1e1a7bd58df00b6,225,58305,5341f4b3a955c8c6a95a0c64736c700b585848d1973b3280e1e1a7bd58df00b6,225,56115,2190,9.73
317,4996a0ceeefc137ca15261683e8b15bc2547058654d01208a34b0cee6a0c10c6,191,17231492,4996a0ceeefc137ca15261683e8b15bc2547058654d01208a34b0cee6a0c10c6,191,17230075,1417,7.42
318,3796ae6b0e5791a6a7a9c9e893ed8d1dbe6b5839174643c140856afa1c5c112b,414,67000000,3796ae6b0e5791a6a7a9c9e893ed8d1dbe6b5839174643c140856afa1c5c112b,414,66993925,6075,14.67
319,e5ffaa397b61410b5fe7b92bf220c1bfaacf780d76741d86fe40aba5890d5e0b,402,277504528,e5ffaa397b61410b5fe7b92bf220c1bfaacf780d76741d86fe40aba5890d5e0b,402,277499530,4998,12.43
320,eeebed367f4daba6e1cf0ca62921138e88b26076295e7e1c53aad17c6f752a6f,8155,305418,eeebed367f4daba6e1cf0ca62921138e88b26076295e7e1c53aad17c6f752a6f,8155,297234,8184,1
321,5d1cac23edc163bcf1d9984c087ffeb8f23685fc66c9b61d6681d90b93c75b2b,226,9256464,5d1cac23edc163bcf1d9984c087ffeb8f23685fc66c9b61d6681d90b93c75b2b,226,9251172,5292,23.42
322,7d8e74f97574f574e56c26a49dd0f4b690cde61b3e339eae0a7440a691048286,371,400834,7d8e74f97574f574e56c26a49dd0f4b690cde61b3e339eae0a7440a691048286,371,396359,4475,12.06
323,e0ffbd35d98d038474efa269e3271b4fc7b82c3deca8af6453d571d63e616813,343,905936,e0ffbd35d98d038474efa269e3271b4fc7b82c3deca8af6453d571d63e616813,343,903182,2754,8.03
324,55e364f4848d5725b819ae49b5ef9d798931840ed19ebd0fefc229c13456b572,419,2280784,55e364f4848d5725b819ae49b5ef9d798931840ed19ebd0fefc229c13456b572,419,2277456,3328,7.94
325,789018e9052b8119f9a8dc87e830a7b0b475a2ae4997740e72bcfcac11363082,191,298176,789018e9052b8119f9a8dc87e830a7b0b475a2ae4997740e72bcfcac11363082,191,292978,5198,27.21
326,c37bfc3f4a0840857aa501994151c46631e34320e6f5dbd5b5674c3731e9ed86,192,199930,c37bfc3f4a0840857aa501994151c46631e34320e6f5dbd5b5674c3731e9ed86,192,197672,2258,11.76
327,261ec5205c1093b640a5eba9688a9624d3b4a12818e81b167ba893a1e6451134,223,84852,261ec5205c1093b640a5eba9688a9624d3b4a12818e81b167ba893a1e6451134,223,81614,3238,14.52
328,396fa70c13fbadfc1e07ca3b72f12f8c02e434c56dfe9a57a5176a2ed7fe7275,223,142438,396fa70c13fbadfc1e07ca3b72f12f8c02e434c56dfe9a57a5176a2ed7fe7275,223,140323,2115,9.48
329,0fe00f8f35018dcf8ed809d7e51b7e5931eafad7ab91436ed3ccd39cc0877c29,267,25017053,0fe00f8f35018dcf8ed809d7e51b7e5931eafad7ab91436ed3ccd39cc0877c29,267,25014176,2877,10.78
330,792896b43124c49890f88690a56fb95e8c5eb0ff982ae7c7af6f8c387f42e06d,189,688057,792896b43124c49890f88690a56fb95e8c5eb0ff982ae7c7af6f8c387f42e06d,189,682009,6048,32
331,8e0abd672963e3d973b7cc4afea9382bd7f79a64aba76b28a976e2332c9c8595,223,3314000,8e0abd672963e3d973b7cc4afea9382bd7f79a64aba76b28a976e2332c9c8595,223,3310762,3238,14.52
332,cb91b0317b103795c528d975b550a2d3a84f2db2c51118c7cbc776b5a49b12c7,8920,266755207,cb91b0317b103795c528d975b550a2d3a84f2db2c51118c7cbc776b5a49b12c7,8920,266603023,152184,17.06
333,eeebc622bcbf673f6f8ecaff205f29d0c4ce865c7a84dcb024a809c7712920b5,1254,1864575,eeebc622bcbf673f6f8ecaff205f29d0c4ce865c7a84dcb024a809c7712920b5,1254,1851954,12621,10.06
334,783dade100a23c198a7d0a272dd94ef1192370fbacb60e68c3bf0be3a7573950,519,47055,783dade100a23c198a7d0a272dd94ef1192370fbacb60e68c3bf0be3a7573950,519,42900,4155,8.01
335,81f6271a949a4af7f7d2eb3b653bb61f56e2ddb097a05a76eb90ec4e435735d4,269,8930,81f6271a949a4af7f7d2eb3b653bb61f56e2ddb097a05a76eb90ec4e435735d4,269,8423,507,1.88
336,1293859bcbb069f0745420e3ea3c013f835571296f44ae327b024d97911da0ac,341,5057,1293859bcbb069f0745420e3ea3c013f835571296f44ae327b024d97911da0ac,341,2372,2685,7.87
337,25c396d2ba08546d55b714ed799bf6040d6494c39ff89f67b69498a542f3fd8f,488,2392594,25c396d2ba08546d55b714ed799bf6040d6494c39ff89f67b69498a542f3fd8f,488,2386959,5635,11.55
338,f7d306f307cba7d6d3675e1ede67a30d7cbd18ff8a0ec0692fa145f48589bae7,191,196624103,f7d306f307cba7d6d3675e1ede67a30d7cbd18ff8a0ec0692fa145f48589bae7,191,196601121,22982,120.32
339,6c26caf80b4e383201ea03a26e33567193732063ee9c88b61b16efd4ccda787c,191,176246268,6c26caf80b4e383201ea03a26e33567193732063ee9c88b61b16efd4ccda787c,191,176236932,9336,48.88
340,ba89b0bb878365fc7d99e39af725e306b9b44eaa562f54c17b1483ec89a9376e,14784,6492945571,ba89b0bb878365fc7d99e39af725e306b9b44eaa562f54c17b1483ec89a9376e,14784,6492745571,200000,13.53
341,c7227754571305f583650809ac5032809d7b6a07d0fb169f8576e64007315f34,8926,47513493,c7227754571305f583650809ac5032809d7b6a07d0fb169f8576e64007315f34,8926,47361309,152184,17.05
342,cabedf095c1b30c090bd303a43234ce09dc6b06340e59f4c72b135af2c9ee0ae,223,4281583,cabedf095c1b30c090bd303a43234ce09dc6b06340e59f4c72b135af2c9ee0ae,223,4278225,3358,15.06
343,dc129943d20052cb0bf96ed22134ed1fd4c5ce62435ca91073f3d43c89dd3eba,370,6187033,dc129943d20052cb0bf96ed22134ed1fd4c5ce62435ca91073f3d43c89dd3eba,370,6182707,4326,11.69
344,f02a015dfde3a1a2155a3b725d9d8427f7a188b1c4f94ee03c8bb50a8e1bde4d,300,28926,f02a015dfde3a1a2155a3b725d9d8427f7a188b1c4f94ee03c8bb50a8e1bde4d,300,25495,3431,11.44
345,60e5ad6140d327b4005489e1e150ce1d6baa37a789800fdc39f3f7c5e3f7e463,194,2136687,60e5ad6140d327b4005489e1e150ce1d6baa37a789800fdc39f3f7c5e3f7e463,194,2135231,1456,7.51
346,92f353316604835cfc2ead5ae4731e812ff0202118e387d07efca8d7b16ac2c3,617,691730,92f353316604835cfc2ead5ae4731e812ff0202118e387d07efca8d7b16ac2c3,617,690466,1264,2.05
347,212eeecb465795c687eb4c74a41854764bf254d5af6e636186d8896ede701b2b,13102,10610446,212eeecb465795c687eb4c74a41854764bf254d5af6e636186d8896ede701b2b,13102,10574817,35629,2.72
348,2b0fd06903632c33dff8f229fe0b7db0dd0b48a0386ca9cbaf10927f608f703f,708,28772692,2b0fd06903632c33dff8f229fe0b7db0dd0b48a0386ca9cbaf10927f608f703f,708,28763782,8910,12.58
349,9274fef0b9c827bb440e8629d3458892cfd3ed4f84dc5625a0d320a6ef27984a,223,2041995,9274fef0b9c827bb440e8629d3458892cfd3ed4f84dc5625a0d320a6ef27984a,223,2036627,5368,24.07
350,a702179911a3df1974ef144b44f49f12667ada0107ed01d3dc5e61061d1482a2,234,976539,a702179911a3df1974ef144b44f49f12667ada0107ed01d3dc5e61061d1482a2,234,972610,3929,16.79
351,e02cdd895750f9c6e3e9459f54118e906873f860d487f6c0fd327c97787f9f21,254,791137,e02cdd895750f9c6e3e9459f54118e906873f860d487f6c0fd327c97787f9f21,254,786985,4152,16.35
352,e03a79d55bd63bdcbd6cea2c60208318e3104c481a0660020624a7e812cb5b71,224,20491,e03a79d55bd63bdcbd6cea2c60208318e3104c481a0660020624a7e812cb5b71,224,17253,3238,14.46
353,e2ab609e8a2ec342382e6d51e814de60b18558a413e0f2c7a720177ad136e478,422,27320567,e2ab609e8a2ec342382e6d51e814de60b18558a413e0f2c7a720177ad136e478,422,27313239,7328,17.36
354,f0b55ab705c116f13bb142614853ac725d2ae44ac5023656c92e4189ccdacd40,226,467315,f0b55ab705c116f13bb142614853ac725d2ae44ac5023656c92e4189ccdacd40,226,465155,2160,9.56
355,174b0ffb382eb73f7f40eefc9853da4ceed37ab92f266a1d431a04c64516096d,370,1023711,174b0ffb382eb73f7f40eefc9853da4ceed37ab92f266a1d431a04c64516096d,370,1019589,4122,11.14
356,4053e05ae3c3fbfd2e1659a789a9fa87523cda60d10dec42f662d468b23b482d,214,2230000,4053e05ae3c3fbfd2e1659a789a9fa87523cda60d10dec42f662d468b23b482d,214,2229835,165,0.77
357,427734a43e3cb366e8ba532a438763d80dd5e056d87f31316e85842be0c3383b,14345,1150173498,427734a43e3cb366e8ba532a438763d80dd5e056d87f31316e85842be0c3383b,14345,1149976491,197007,13.73
358,71ea886391036214c652f276cb177c599fe64d0879eddcb4d3ca2d879d2d9a79,370,307450,71ea886391036214c652f276cb177c599fe64d0879eddcb4d3ca2d879d2d9a79,370,304752,2698,7.29
359,af6b486a4a1cda817ca55721a15ce7dfd452f1b74d4bc698d531c47999cdfd7a,223,972400,af6b486a4a1cda817ca55721a15ce7dfd452f1b74d4bc698d531c47999cdfd7a,223,971500,900,4.04
360,3720f1f66ff6818916bac0e17aeb20fe27f9cfa375970371ceb736b928556d5c,223,23919983,3720f1f66ff6818916bac0e17aeb20fe27f9cfa375970371ceb736b928556d5c,223,23917775,2208,9.9
361,5ca94a371cb4116a2dd6b30a2224c4d52cf4ffb350ac9e73dc250962d6fa3580,287,325029936,5ca94a371cb4116a2dd6b30a2224c4d52cf4ffb350ac9e73dc250962d6fa3580,287,325026640,3296,11.48
362,5cb83121a3b033c39d5afb0f82af1617cbb7850bf6f6809c0f16d0f0201e9ac7,222,1210930,5cb83121a3b033c39d5afb0f82af1617cbb7850bf6f6809c0f16d0f0201e9ac7,222,1207715,3215,14.48
363,9bf380a469a80e39dbff670d10399d8a45cd559817bbcf11a0fecd52ce17120c,225,196769,9bf380a469a80e39dbff670d10399d8a45cd559817bbcf11a0fecd52ce17120c,225,194609,2160,9.6
364,c483d57bd507470beaf96a71d388856a2ffa87a96e50867f252133bbbf2ed608,224,9555602,c483d57bd507470beaf96a71d388856a2ffa87a96e50867f252133bbbf2ed608,224,9536562,19040,85
365,df239c7e5b80d345faee7f2c369a6d3cfaaf1d3482c5897d8811e56fc84a31ff,380,2846671,df239c7e5b80d345faee7f2c369a6d3cfaaf1d3482c5897d8811e56fc84a31ff,380,2843851,2820,7.42
366,f508f84a5bd762b2ea890cfaf8928073a8c1bec563acb946266c79edcee514e5,405,5707,f508f84a5bd762b2ea890cfaf8928073a8c1bec563acb946266c79edcee514e5,405,5393,314,0.78
367,fd1dba03c7bf27410973a3dd40e58aed12411c32c4158883e7584af6d0ada7c7,371,6639362,fd1dba03c7bf27410973a3dd40e58aed12411c32c4158883e7584af6d0ada7c7,371,6631681,7681,20.7
368,0dbda147076361e90b4258479a5ebd85c303409f20f0f7b6005798b798db8466,279,13872227,0dbda147076361e90b4258479a5ebd85c303409f20f0f7b6005798b798db8466,279,13861562,10665,38.23
369,7e6714b58ff8c0a6b94ffc9d725d15d95517df710c0c72c58ade8ca5f1658ee5,222,3034391,7e6714b58ff8c0a6b94ffc9d725d15d95517df710c0c72c58ade8ca5f1658ee5,222,3020416,13975,62.95
370,b017fd7c19e7c7d39eed5c06de7fb5797a5f8017a625f5ffa3896eea73f78d34,224,1130840,b017fd7c19e7c7d39eed5c06de7fb5797a5f8017a625f5ffa3896eea73f78d34,224,1127676,3164,14.12
371,3dbd2f63c1e36172fd802a7b9f50a2540690af51d35540c1b5fcb7578456a630,14785,263405277,3dbd2f63c1e36172fd802a7b9f50a2540690af51d35540c1b5fcb7578456a630,14785,263205277,200000,13.53
372,b0473d670e56660ee50a18477178d1e525384fa410d2f8e601659fd42b0ea32e,564,1210693,b0473d670e56660ee50a18477178d1e525384fa410d2f8e601659fd42b0ea32e,564,1208770,1923,3.41
373,b0df54af9943d78ccbed5cd4187122c2f7aae494099d979dbfafc5a5e2198e67,191,152496,b0df54af9943d78ccbed5cd4187122c2f7aae494099d979dbfafc5a5e2198e67,191,134688,17808,93.24
374,ee346d4bbb445b48a2e54c1f08ef41f713699afc47413fed53d0b9ebdcb5c4ad,226,78206,ee346d4bbb445b48a2e54c1f08ef41f713699afc47413fed53d0b9ebdcb5c4ad,226,76046,2160,9.56
375,9b6a520298e8fce8c22b91f1d39db79f30a7af227e1666c2143758ff917a193c,225,7648152,9b6a520298e8fce8c22b91f1d39db79f30a7af227e1666c2143758ff917a193c,225,7645581,2571,11.43
376,e3ecb473736a1dc6b658bbf7d0d74bd08eb0d515d32d97e753019acd35006414,682,2407783,e3ecb473736a1dc6b658bbf7d0d74bd08eb0d515d32d97e753019acd35006414,682,2401023,6760,9.91
377,b3a9997791493cf1e8b4d8a1fa6ecbcdc9186b05fff0511f7a73f6fce2207beb,669,323100,b3a9997791493cf1e8b4d8a1fa6ecbcdc9186b05fff0511f7a73f6fce2207beb,669,312600,10500,15.7
378,be8bc5e2226df3aec1ce91d29f23e8919bc7b21fb59d4b339cc6525d35b66606,378,3896400,be8bc5e2226df3aec1ce91d29f23e8919bc7b21fb59d4b339cc6525d35b66606,378,3893830,2570,6.8
379,7edb687dd1318fe46a0dd528c12c7fc69ba1ed5cc38f5c172b8e8a19bef18228,191,197572591,7edb687dd1318fe46a0dd528c12c7fc69ba1ed5cc38f5c172b8e8a19bef18228,191,197559768,12823,67.14
380,a5683eda887f74046f4acd7af340926136192075384ab2e6043e53bba59e4ae7,226,317945,a5683eda887f74046f4acd7af340926136192075384ab2e6043e53bba59e4ae7,226,314661,3284,14.53
381,c397853c42412a382ef9ffb60d41a0549d3adc55c01583677ad4780c4f545b5b,381,18003250,c397853c42412a382ef9ffb60d41a0549d3adc55c01583677ad4780c4f545b5b,381,17997139,6111,16.04
382,e4645c1969e7a69400657aa7d833250d20281b81f9faa685070f08f7c21e2c3c,2812,17775200,e4645c1969e7a69400657aa7d833250d20281b81f9faa685070f08f7c21e2c3c,2812,17742675,32525,11.57
383,26331c7090bb1002b7154218cc4733ec07d1af1c2ebeec6182d0d63be2b46800,225,969088,26331c7090bb1002b7154218cc4733ec07d1af1c2ebeec6182d0d63be2b46800,225,966193,2895,12.87
384,752308ae89473892e0b90f29adcb826aa5c9fb6b7cf5ea1dffe4b11bdc40c43f,370,8651837,752308ae89473892e0b90f29adcb826aa5c9fb6b7cf5ea1dffe4b11bdc40c43f,370,8641337,10500,28.38
385,a284b5f354a719449dc505670de81a29ae3fdf9f6d5f63224b16df3f30e9eb5d,191,156019889,a284b5f354a719449dc505670de81a29ae3fdf9f6d5f63224b16df3f30e9eb5d,191,155959019,60870,318.69
386,19f087e0e3416afefe8af9649d4d8341bc58e297d9efa51403a4b77ff0345dd5,253,403341637,19f087e0e3416afefe8af9649d4d8341bc58e297d9efa51403a4b77ff0345dd5,253,403339324,2313,9.14
387,8997b6b39aa9e0a6f2f9e3e136fb78d6dd642441b386795d9976fd50760844da,223,5004050,8997b6b39aa9e0a6f2f9e3e136fb78d6dd642441b386795d9976fd50760844da,223,4995745,8305,37.24
388,eb54758123e8b3ca034a231c2685a86e8ba1dca3d89cde3feed383736253c866,234,978225,eb54758123e8b3ca034a231c2685a86e8ba1dca3d89cde3feed383736253c866,234,974296,3929,16.79
389,9a062561d1ad2e22fd51c08a9631d7bda5a3e8f18f513a94ff34dc8cd8cacaf1,223,1772947,9a062561d1ad2e22fd51c08a9631d7bda5a3e8f18f513a94ff34dc8cd8cacaf1,223,1770832,2115,9.48
390,632c3fb4c4b229f44104100fccbd627f427380ccc13eb3fde255b7002a4e0739,223,1441350,632c3fb4c4b229f44104100fccbd627f427380ccc13eb3fde255b7002a4e0739,223,1437966,3384,15.17
391,7500000be345ef2d3994b206320abe8a0e0d91eeb154558e8ddf17558f4afb29,223,23670296,7500000be345ef2d3994b206320abe8a0e0d91eeb154558e8ddf17558f4afb29,223,23668570,1726,7.74
392,8a7b19185f55d8e93305524c4b8d505fa5f2a7e39cebab16e02bc07068e156b7,222,1206121,8a7b19185f55d8e93305524c4b8d505fa5f2a7e39cebab16e02bc07068e156b7,222,1204006,2115,9.53
393,0a6c02f4aad19c0d4f9dd0759c9ee14ebc55aecd437ed43c23dfbd47644a6479,222,6125429,0a6c02f4aad19c0d4f9dd0759c9ee14ebc55aecd437ed43c23dfbd47644a6479,222,6123609,1820,8.2
394,002c44d831a189ea4530e264500493f7fca4dc4115a3ba76bf8864c574edb06c,234,973529,002c44d831a189ea4530e264500493f7fca4dc4115a3ba76bf8864c574edb06c,234,969596,3933,16.81
395,3cb5ba71f5569be2e7de894f10d0539a8356bbf65fac7a3865e9fef9aff38454,7855,112349294,3cb5ba71f5569be2e7de894f10d0539a8356bbf65fac7a3865e9fef9aff38454,7855,112237221,112073,14.27
396,4fddc835357600f5cac5aec0937070da0b4d9251bc17cd10f7def5b9eb2efe22,217,6494270,4fddc835357600f5cac5aec0937070da0b4d9251bc17cd10f7def5b9eb2efe22,217,6492650,1620,7.47
397,429cf828cc11cb16b02d5046d990d6ae0a0fb1bbd9d72e306b479395e247bda8,223,3418234,429cf828cc11cb16b02d5046d990d6ae0a0fb1bbd9d72e306b479395e247bda8,223,3415334,2900,13
398,8d9d2bea77f6afb941b0ca60f0247694f21c2bff37c8bf39a9e4b5dd6af9277b,247,491780,8d9d2bea77f6afb941b0ca60f0247694f21c2bff37c8bf39a9e4b5dd6af9277b,247,489190,2590,10.49
399,ec9f530131001385fd4df8fd03e912e78a10365a2ba2c8b2ead88f3b14a9e47a,191,352127,ec9f530131001385fd4df8fd03e912e78a10365a2ba2c8b2ead88f3b14a9e47a,191,348290,3837,20.09
400,4872a6f85ef27a5ffcf765551e8bd6fa2194b71bb47c406c4fe055eaf6ab5e87,221,49576,4872a6f85ef27a5ffcf765551e8bd6fa2194b71bb47c406c4fe055eaf6ab5e87,221,45578,3998,18.09
401,97299d617e75dac8c0485572667fb00d58bf103bbf88492c591cbf6ff77172de,224,230333,97299d617e75dac8c0485572667fb00d58bf103bbf88492c591cbf6ff77172de,224,228029,2304,10.29
402,9bc226239255ff2d84a0462f2321f19b2bbdcbb58e3f41b36c646dba9cca0da7,519,120655,9bc226239255ff2d84a0462f2321f19b2bbdcbb58e3f41b36c646dba9cca0da7,519,114303,6352,12.24
403,1cb7fa40d39961feb817d9821d69b3fe6ff26da735c0aff0536f99507443ec7d,223,4193361,1cb7fa40d39961feb817d9821d69b3fe6ff26da735c0aff0536f99507443ec7d,223,4190146,3215,14.42
404,2ceecd99757212ab41b69a9ca5d6688fd76e0c42632e4038719eb2c3daa297af,224,223617,2ceecd99757212ab41b69a9ca5d6688fd76e0c42632e4038719eb2c3daa297af,224,221879,1738,7.76
405,73757b82609e7bb5ce9003de78e08673e72078618a653c4eb1c0bdfec2cb0f7d,372,702367,73757b82609e7bb5ce9003de78e08673e72078618a653c4eb1c0bdfec2cb0f7d,372,694887,7480,20.11
406,7e8e0727b34cbf132cbb8d2d3de4eae563a79ee85d4cb33e5e00040f5b63f0f8,223,1191970,7e8e0727b34cbf132cbb8d2d3de4eae563a79ee85d4cb33e5e00040f5b63f0f8,223,1188755,3215,14.42
407,7ff5736bdd9fbac78e9766ee44a8b5c3b37c2368a00373614060453815cfd251,223,1380091,7ff5736bdd9fbac78e9766ee44a8b5c3b37c2368a00373614060453815cfd251,223,1376924,3167,14.2
408,f5fbf5d02fa51bc03f1be7648abb00deb2a5b721bfbfe34dec4fa6d89be794f9,4021,11277746108,f5fbf5d02fa51bc03f1be7648abb00deb2a5b721bfbfe34dec4fa6d89be794f9,4021,11277688703,57405,14.28
409,362d3f1ae0ee31cdffafa181f858209de0bb82e29f450220c81f26864b0c72e1,279,2104627,362d3f1ae0ee31cdffafa181f858209de0bb82e29f450220c81f26864b0c72e1,279,2101032,3595,12.89
410,4d43a9ec288647cd3b9cd4a4172799563e451456ea713933101300077e8fcd92,222,232835,4d43a9ec288647cd3b9cd4a4172799563e451456ea713933101300077e8fcd92,222,231015,1820,8.2
411,4fe68e12ce81abf47609129d9569829c6764e05e29321c3fff181fa5a1615c68,965,458622,4fe68e12ce81abf47609129d9569829c6764e05e29321c3fff181fa5a1615c68,965,451407,7215,7.48
412,9ef6a09085e25f546730d301172d887635523cfed1365c6ce8beb9a0d246a60a,193,675146,9ef6a09085e25f546730d301172d887635523cfed1365c6ce8beb9a0d246a60a,193,672464,2682,13.9
413,d612f0c57e2e8291b55dfc1cf9259b7fc6e60b23dfbba29bbcc6672aae9000ce,418,34955218,d612f0c57e2e8291b55dfc1cf9259b7fc6e60b23dfbba29bbcc6672aae9000ce,418,34942418,12800,30.62
414,ddadbd1ddbddd9d28500bfd8717076ab934e7d4302b9b648d6d1544a3a014e7d,215,331092,ddadbd1ddbddd9d28500bfd8717076ab934e7d4302b9b648d6d1544a3a014e7d,215,328428,2664,12.39
415,a002542d1c5131b34e1fddbaa9d45f74cfe3aac25f0de541b352d86ba587c7a7,375,285318,a002542d1c5131b34e1fddbaa9d45f74cfe3aac25f0de541b352d86ba587c7a7,375,282336,2982,7.95
416,2e6183c48b849fcf13a07e484b74c29b1a70769219ba5666aad62f0da2974bf2,374,1931751,2e6183c48b849fcf13a07e484b74c29b1a70769219ba5666aad62f0da2974bf2,374,1926908,4843,12.95
417,51cb6b0b675a8f2a4489760ae532dc8f8a42e0106a490720808802090737aa76,224,82700,51cb6b0b675a8f2a4489760ae532dc8f8a42e0106a490720808802090737aa76,224,81273,1427,6.37
418,d51ac322bdbd302cb6bd458f997c1be2d4ac78f7dfd9fbc66dfba9f9e97685f1,223,252166,d51ac322bdbd302cb6bd458f997c1be2d4ac78f7dfd9fbc66dfba9f9e97685f1,223,247014,5152,23.1
419,41f498d568518e23b7d9d9654447c90e194656195449c2210afdebc60c77a198,222,721023,41f498d568518e23b7d9d9654447c90e194656195449c2210afdebc60c77a198,222,719206,1817,8.18
420,4dc61c49546e55e30d1a9e5820621e848090ebef277acb6a707d101d0c220dad,341,106510,4dc61c49546e55e30d1a9e5820621e848090ebef277acb6a707d101d0c220dad,341,99328,7182,21.06
421,64c57398d1821b1840b8504571363962e8f02fd364cfeb7588a70c562a0a1855,191,18464,64c57398d1821b1840b8504571363962e8f02fd364cfeb7588a70c562a0a1855,191,16814,1650,8.64
422,993e86a0d1f56d3c3617c149a3a61155812475badc0bee85d1af9b0dd26a4d6e,222,140000,993e86a0d1f56d3c3617c149a3a61155812475badc0bee85d1af9b0dd26a4d6e,222,138274,1726,7.77
423,675d01e953a80b34a39222d727c639a839edbc5d2f1bef6184eccb6f7f7532d8,223,1884157,675d01e953a80b34a39222d727c639a839edbc5d2f1bef6184eccb6f7f7532d8,223,1881257,2900,13
424,967728af69f95c5e429767bb499a193984228b9e928a07614b3b065d633f9e6a,192,3284560,967728af69f95c5e429767bb499a193984228b9e928a07614b3b065d633f9e6a,192,3282041,2519,13.12
425,75de9604d34212d3c8fb045815903b06257e94213ac1b88b7515744f95159926,383,43986342,75de9604d34212d3c8fb045815903b06257e94213ac1b88b7515744f95159926,383,43981131,5211,13.61
426,79916e91cb225e955c82ef17e38237f27f1da64357b6760953664ee4398c6a1c,224,2319529,79916e91cb225e955c82ef17e38237f27f1da64357b6760953664ee4398c6a1c,224,2314459,5070,22.63
427,9a6eb6f323f6f26f09d79e23c2a3f298739b63022ca6402dac43c4a3cd0942e1,222,84963,9a6eb6f323f6f26f09d79e23c2a3f298739b63022ca6402dac43c4a3cd0942e1,222,82707,2256,10.16
428,f33d04dec4315de8bdf8190845efb3a0510d7b35fb674eac7b1304e1e9d7ec13,269,10100,f33d04dec4315de8bdf8190845efb3a0510d7b35fb674eac7b1304e1e9d7ec13,269,9593,507,1.88
429,3b75ceb1ac55abb4d993ef6d643a4af6221be14c241f0b9512780dfc6967693e,969,23856378,3b75ceb1ac55abb4d993ef6d643a4af6221be14c241f0b9512780dfc6967693e,969,23840412,15966,16.48
430,400c6f815d82f333599f9a93ed140896ac1c7094379f0383205dba10be0b86f1,225,54700,400c6f815d82f333599f9a93ed140896ac1c7094379f0383205dba10be0b86f1,225,51820,2880,12.8
431,a95eecd9a3683a6bd768cd948f97ed6100a31571b519e7634b92046a1d7fa289,247,353148753,a95eecd9a3683a6bd768cd948f97ed6100a31571b519e7634b92046a1d7fa289,247,353146485,2268,9.18
432,df0c301819b69f05951963e51978c517b6f9fd5e79a42cf57637bec554d0c52a,194,209000,df0c301819b69f05951963e51978c517b6f9fd5e79a42cf57637bec554d0c52a,194,167418,41582,214.34
433,5dcf71a3976f1be112b68676ae090ef1aa7af3a33fb0e5e7c497831a9107004d,222,2028105,5dcf71a3976f1be112b68676ae090ef1aa7af3a33fb0e5e7c497831a9107004d,222,2022775,5330,24.01
434,f587a4d7caae1e680229afd638268a8e6c6606b25952b4062fd55710d34680f9,191,137142139,f587a4d7caae1e680229afd638268a8e6c6606b25952b4062fd55710d34680f9,191,137138556,3583,18.76
435,104255b1fb411407085c0d870dfd8dfd3e16cca0a500f6277dcc138bb90447f3,224,64686,104255b1fb411407085c0d870dfd8dfd3e16cca0a500f6277dcc138bb90447f3,224,61786,2900,12.95
436,2e7995dc369aac4612e5c692b5290d656e3244e30251cce36e6713305c7de524,14804,186639485,2e7995dc369aac4612e5c692b5290d656e3244e30251cce36e6713305c7de524,14804,186439485,200000,13.51
437,56d5232d97b2f11b144991b0ffe4096ed8945d4ec6c00e892a83699192ac1767,191,1444346,56d5232d97b2f11b144991b0ffe4096ed8945d4ec6c00e892a83699192ac1767,191,1442146,2200,11.52
438,83f4dfd5c862fbdc1d02f63e36b0283f67884347de293a45613fdd9d6e5b53bc,405,5707,83f4dfd5c862fbdc1d02f63e36b0283f67884347de293a45613fdd9d6e5b53bc,405,5393,314,0.78
439,ca1eb5820c9464ba28fc19e66cd164f4c1542c9a1212685bb9d0f42e9cff4edb,195,563718,ca1eb5820c9464ba28fc19e66cd164f4c1542c9a1212685bb9d0f42e9cff4edb,195,562255,1463,7.5
440,1adad6c65454a8ec5607f1511f33e85639f28cd855a2e1fbd5808b7957acc042,226,259336,1adad6c65454a8ec5607f1511f33e85639f28cd855a2e1fbd5808b7957acc042,226,252473,6863,30.37
441,f4249785302c3e17b92b4a75454ab28233ab3359211cecc6e6fdf47ebb65fb26,192,55458,f4249785302c3e17b92b4a75454ab28233ab3359211cecc6e6fdf47ebb65fb26,192,52508,2950,15.36
442,aa66a4b34cb119f17523978a27a7f0943684c69c148a21a6396681c0e46c8c87,402,913344523,aa66a4b34cb119f17523978a27a7f0943684c69c148a21a6396681c0e46c8c87,402,913339525,4998,12.43
443,d7c1774ff8459dc34d19f8e57562ad31c3498b9ce30e1cd3bd12ab0cea65cf94,492,48863517,d7c1774ff8459dc34d19f8e57562ad31c3498b9ce30e1cd3bd12ab0cea65cf94,492,48857000,6517,13.25
444,3e0e1351f55c9c2a362a6053de9352e5ba03e0e4294ed091fe21a2506cb7ab7c,223,1486787,3e0e1351f55c9c2a362a6053de9352e5ba03e0e4294ed091fe21a2506cb7ab7c,223,1484967,1820,8.16
445,7734c0ebf4ddb3db3614f23630b669d5fc28592994850ca48c2fc0c869772012,225,1010434,7734c0ebf4ddb3db3614f23630b669d5fc28592994850ca48c2fc0c869772012,225,1000120,10314,45.84
446,b643339fac617e76f0f0541aefb37f861bda836b2df97915d60353025207d7f1,215,315900,b643339fac617e76f0f0541aefb37f861bda836b2df97915d60353025207d7f1,215,313598,2302,10.71
447,c65f4c1b13bfe5314750a4dee226fd33fc9db02b15fa253fce18b9ae76e87ad6,191,229828573,c65f4c1b13bfe5314750a4dee226fd33fc9db02b15fa253fce18b9ae76e87ad6,191,229759298,69275,362.7
448,e97a318b5a82076a008a11a11090c6edf5736ee3c7ca5bb7777006ddf3f569fa,226,44388644,e97a318b5a82076a008a11a11090c6edf5736ee3c7ca5bb7777006ddf3f569fa,226,44383200,5444,24.09
449,0abf09ab331b1f8122d47653fbdbec504e31432fbe0a0a7f99b7d3ec66ab4330,14794,393813904,0abf09ab331b1f8122d47653fbdbec504e31432fbe0a0a7f99b7d3ec66ab4330,14794,393613904,200000,13.52
450,50831d4c599b84321a6c44fae2694ebd879c7009b5adc3df2c99f5047dc90a6c,371,205014,50831d4c599b84321a6c44fae2694ebd879c7009b5adc3df2c99f5047dc90a6c,371,202316,2698,7.27
451,68ea36c884b705afe580e091e4c8c58b640e3936cb6d3888ab0a6da35fe657ce,407,133156,68ea36c884b705afe580e091e4c8c58b640e3936cb6d3888ab0a6da35fe657ce,407,132862,294,0.72
452,6c87742ca64e39ffc8237da4c13d41e259c3269eedf551cd5e9dd6928cb2aba3,223,188599214,6c87742ca64e39ffc8237da4c13d41e259c3269eedf551cd5e9dd6928cb2aba3,223,188597006,2208,9.9
453,7d3e9f361689966a96f985d92b23a0b3f4d1667d148bb248a385315132d6fcad,341,3456968,7d3e9f361689966a96f985d92b23a0b3f4d1667d148bb248a385315132d6fcad,341,3447054,9914,29.07
454,848aa2d689c318f8f49ecb341a19f0bd4df9106da785141f1c5b7cd5dcc28f2d,14792,218798121,848aa2d689c318f8f49ecb341a19f0bd4df9106da785141f1c5b7cd5dcc28f2d,14792,218598121,200000,13.52
455,2fb252085436fd79af03dec994289047711953507bc49cd8ff349f0a1614be02,371,1599964,2fb252085436fd79af03dec994289047711953507bc49cd8ff349f0a1614be02,371,1598829,1135,3.06
456,3ba9025bdd42b6a8b8c22fdae09496cfa259afd619b48d4eddbf291a29bb3ffc,224,8465662,3ba9025bdd42b6a8b8c22fdae09496cfa259afd619b48d4eddbf291a29bb3ffc,224,8463964,1698,7.58
457,5272ce2156880168a6ef57d100822e2bbd0c06f5303eb69393ec68f3e170d7d6,488,69804,5272ce2156880168a6ef57d100822e2bbd0c06f5303eb69393ec68f3e170d7d6,488,66146,3658,7.5
458,7245f6afb575ec9e850c8b4182b82fed25122509bf51e372b3f7083ed16c86ab,191,548330,7245f6afb575ec9e850c8b4182b82fed25122509bf51e372b3f7083ed16c86ab,191,547890,440,2.3
459,9d718b8f56a9e2a1044752147cc1dc47d6a4ca265e2658392a25b0c433e5ac03,191,16534,9d718b8f56a9e2a1044752147cc1dc47d6a4ca265e2658392a25b0c433e5ac03,191,16297,237,1.24
460,577a209110ca87e8fd0c3aabae45c85324179090480ba0190f9b847abde18758,336,1305447,577a209110ca87e8fd0c3aabae45c85324179090480ba0190f9b847abde18758,336,1290172,15275,45.46
461,765c535b86592d9be49e04fc807262db9bac8ed2fa1ee22e238d998db1dce234,821,685298,765c535b86592d9be49e04fc807262db9bac8ed2fa1ee22e238d998db1dce234,821,675781,9517,11.59
462,2dd26fb05fd399a20eb9eab91771f5aea1e09c52bb9c48da94c5c084b246ed62,221,218259,2dd26fb05fd399a20eb9eab91771f5aea1e09c52bb9c48da94c5c084b246ed62,221,216049,2210,10
463,9b31d63535d886f584598d68e1aed4c0fc4eafd5ac5057f13ade1a92b0672c21,327,3100000,9b31d63535d886f584598d68e1aed4c0fc4eafd5ac5057f13ade1a92b0672c21,327,3089651,10349,31.65
464,bb1e3515d7db3f50476735bf9ec86ff54818d0a0d95fa6a9f968da8d4bf23ebb,483,42083,bb1e3515d7db3f50476735bf9ec86ff54818d0a0d95fa6a9f968da8d4bf23ebb,483,33904,8179,16.93
465,74771b2af0974392ba084f9b8cb528940fd688dc4af883aa5a7bdf65fc5ddebf,223,1937960,74771b2af0974392ba084f9b8cb528940fd688dc4af883aa5a7bdf65fc5ddebf,223,1932592,5368,24.07
466,d7eb23e69f749715d0871a84740b2040da60d4879d633f3b664e634c9b56543f,191,168236386,d7eb23e69f749715d0871a84740b2040da60d4879d633f3b664e634c9b56543f,191,168072072,164314,860.28
467,1b8dd6a8996ed5f3229b3b69d8d83cfac5747a7da09e6a80ad41c880b919a5cb,483,523414,1b8dd6a8996ed5f3229b3b69d8d83cfac5747a7da09e6a80ad41c880b919a5cb,483,518046,5368,11.11
468,3bba02fe8437cd1590d859252ad36ed3cdddbfeedcf087724d7776c4ce105cc9,191,3526146,3bba02fe8437cd1590d859252ad36ed3cdddbfeedcf087724d7776c4ce105cc9,191,3519958,6188,32.4
469,775dd720d6170c44ec514932f284f0b96e68554ff04f165c1259f9135a7485de,223,13947528,775dd720d6170c44ec514932f284f0b96e68554ff04f165c1259f9135a7485de,223,13943268,4260,19.1
470,f8c578521b96749bad8f024354675b8517021dd9301b2aed622ff677ad121df1,223,1046765,f8c578521b96749bad8f024354675b8517021dd9301b2aed622ff677ad121df1,223,1040833,5932,26.6
471,07d7c22c9d5a5f1f59adad8da0798284ecf949d47fdef356d52411b546a28910,666,989151,07d7c22c9d5a5f1f59adad8da0798284ecf949d47fdef356d52411b546a28910,666,967807,21344,32.05
472,0d12a1aedce6182cf0408aa39dabf5000086b78a032d08ee00272506e83c78ed,924,648630,0d12a1aedce6182cf0408aa39dabf5000086b78a032d08ee00272506e83c78ed,924,638378,10252,11.1
473,25c73740caa083e2c30de7a6aed147c48e2a426d89eb75b6776329c415c02297,346,4257996,25c73740caa083e2c30de7a6aed147c48e2a426d89eb75b6776329c415c02297,346,4252688,5308,15.34
474,3879163d7807eee6af6c06dff206e0abe31216ce733de55a1c4da3d245e21848,931,25100719,3879163d7807eee6af6c06dff206e0abe31216ce733de55a1c4da3d245e21848,931,25089469,11250,12.08
475,4fb1bb925df28845b069f6856e5a1863721a692e3aa5b7ce86c8d15a6bd5d017,340,81955,4fb1bb925df28845b069f6856e5a1863721a692e3aa5b7ce86c8d15a6bd5d017,340,79620,2335,6.87
476,6196bba00840bea7c487369bb02c75b1b6fc4e7ad6076e0179605ac46362065e,785,8587765,6196bba00840bea7c487369bb02c75b1b6fc4e7ad6076e0179605ac46362065e,785,8585449,2316,2.95
477,74bba714ff3e146721b5bb7c53f5c8fba5e5c37350417aa027a12a42f3773beb,337,12756707,74bba714ff3e146721b5bb7c53f5c8fba5e5c37350417aa027a12a42f3773beb,337,12749907,6800,20.18
478,946f78a5fd760621f372062af3e067c979c6ed542cd23109ceb8671234cf3578,13918,1229109752,946f78a5fd760621f372062af3e067c979c6ed542cd23109ceb8671234cf3578,13918,1228911451,198301,14.25
479,3b05397442baaf9173ad356816b281bfd64f851320c4cceec1af17579e287a1e,223,1799781,3b05397442baaf9173ad356816b281bfd64f851320c4cceec1af17579e287a1e,223,1796941,2840,12.74
480,73d36bb08e233027f10dbb2aadf222e24d64ef372cc1499f7af24422fd1db45e,1726,6059880000,73d36bb08e233027f10dbb2aadf222e24d64ef372cc1499f7af24422fd1db45e,1726,6059440680,439320,254.53
481,fc83145b7c29dba9f817de23f3aa8a962052636a1628aba302723635ae345aa1,191,257432800,fc83145b7c29dba9f817de23f3aa8a962052636a1628aba302723635ae345aa1,191,257247280,185520,971.31
482,36b7b19f275f9f3ae6a070ed597c1ad7ed3cc7c8e8affd5768d856e31cc3ffda,194,170448,36b7b19f275f9f3ae6a070ed597c1ad7ed3cc7c8e8affd5768d856e31cc3ffda,194,165836,4612,23.77
483,4e65cefa560236aee2b6fd44b8900fe4547ffb267f00e265e924598b3e195264,234,973213,4e65cefa560236aee2b6fd44b8900fe4547ffb267f00e265e924598b3e195264,234,969280,3933,16.81
484,634710074e447e68989f1e58929c32942b584058873f37dbc06a614286b0520e,14794,395109156,634710074e447e68989f1e58929c32942b584058873f37dbc06a614286b0520e,14794,394909156,200000,13.52
485,68becd9329201440f13402397eace5bd08bd7acd1fa9f8b917a8d44121833432,191,6049917,68becd9329201440f13402397eace5bd08bd7acd1fa9f8b917a8d44121833432,191,6045433,4484,23.48
486,c05a089f9ae0d36cd8f2776647bb780360d94fba2f95fa429d57aa570fbeb0a8,698,2747613,c05a089f9ae0d36cd8f2776647bb780360d94fba2f95fa429d57aa570fbeb0a8,698,2726553,21060,30.17
487,01781a87ccc220f49e1b5b78d4e64fd0c8d6eb14a71124837c336dfec51815ed,637,2252011,01781a87ccc220f49e1b5b78d4e64fd0c8d6eb14a71124837c336dfec51815ed,637,2249491,2520,3.96
488,3613a3bfd3067401cc4d7d39503776f5a57ee80fe63dc797be74ea062b051b3a,222,113221315,3613a3bfd3067401cc4d7d39503776f5a57ee80fe63dc797be74ea062b051b3a,222,113218100,3215,14.48
489,496fa3fac4bf0cad999fd7c1bd8868b7e616fa0a87235980783ce9f2fe942d19,194,3582722,496fa3fac4bf0cad999fd7c1bd8868b7e616fa0a87235980783ce9f2fe942d19,194,3576092,6630,34.18
490,c9d33abb2136c833860062ea471e34371f1ffc32c18d8056540927e2451e46fc,370,21051625,c9d33abb2136c833860062ea471e34371f1ffc32c18d8056540927e2451e46fc,370,21048927,2698,7.29
491,fa5bc5d9f34b5bf2dbd65344a78b234e3ce60ecba27a300e4b4e2b249ad07625,383,3202758,fa5bc5d9f34b5bf2dbd65344a78b234e3ce60ecba27a300e4b4e2b249ad07625,383,3197933,4825,12.6
492,68946522f84bf312f0cba32ae8b546350eeddc2070427e27b7c567af20fe1488,225,5874388,68946522f84bf312f0cba32ae8b546350eeddc2070427e27b7c567af20fe1488,225,5872935,1453,6.46
493,add7d8890080e508e12778b15c8dc28a125596032b37fd7869660e336281f9d9,406,20707,add7d8890080e508e12778b15c8dc28a125596032b37fd7869660e336281f9d9,406,20393,314,0.77
494,af4775b220070a3b70c1e74b057a9f1147dca48dd3e78542601f5139fcfce62b,215,2602713,af4775b220070a3b70c1e74b057a9f1147dca48dd3e78542601f5139fcfce62b,215,2600793,1920,8.93
495,152b533deb663494cfc966e4102ad69c83ffe447e82ed69867f22cd52a514c63,255,427527492,152b533deb663494cfc966e4102ad69c83ffe447e82ed69867f22cd52a514c63,255,427524372,3120,12.24
496,dbf9f4516417e8184a628ebf73fe460884e33b591c8ece1706ee0b08ae3e11cf,339,1122040,dbf9f4516417e8184a628ebf73fe460884e33b591c8ece1706ee0b08ae3e11cf,339,1119794,2246,6.63
497,123c73380e07966d333f021fcf299de01091acb3d1ea144fe42b54f3ae3f6d3c,222,3788827692,123c73380e07966d333f021fcf299de01091acb3d1ea144fe42b54f3ae3f6d3c,222,3788823885,3807,17.15
498,ec579a25277808659b33b274e557dc4028090676ebcafcf48f3a86fee574b56f,373,272778,ec579a25277808659b33b274e557dc4028090676ebcafcf48f3a86fee574b56f,373,270074,2704,7.25
499,131b50828e856a6a766f3d12853e66d79834f6f92a49da3644d4f8b3fa001e92,223,339070,131b50828e856a6a766f3d12853e66d79834f6f92a49da3644d4f8b3fa001e92,223,333851,5219,23.4
500,43e899daa4d16fbf46dcd14267a8a6f82e90479d9dd7b91b6998749a8b8998a0,222,783354,43e899daa4d16fbf46dcd14267a8a6f82e90479d9dd7b91b6998749a8b8998a0,222,780351,3003,13.53
501,4b9f8369aab2302caf61f04d6e37f4adfd521c37fac364a8a197e0be963dde36,255,279926875,4b9f8369aab2302caf61f04d6e37f4adfd521c37fac364a8a197e0be963dde36,255,279899794,27081,106.2
502,cb5d5e0b84cb77f731793f4f535bac6e56bc7d5acc572794d93046dfbdcc66e0,2950,1714258,cb5d5e0b84cb77f731793f4f535bac6e56bc7d5acc572794d93046dfbdcc66e0,2950,1708447,5811,1.97
503,10d1c5e00cc8f715dbfd67a4d7281b3f0338bc28ddd98442e5f64360b6275be8,223,150233664,10d1c5e00cc8f715dbfd67a4d7281b3f0338bc28ddd98442e5f64360b6275be8,223,150230784,2880,12.91
504,11cac09ae3e1270b436ec0626c3a01bc26423e7fa7be0e3771600b3032f24eed,222,8390154046,11cac09ae3e1270b436ec0626c3a01bc26423e7fa7be0e3771600b3032f24eed,222,8390151508,2538,11.43
505,41fcce95ab65b8cfcd67a92a939ed554a390e2954db55e9bd3a50d09b35b874f,371,359372,41fcce95ab65b8cfcd67a92a939ed554a390e2954db55e9bd3a50d09b35b874f,371,356802,2570,6.93
506,1689aeaebcd6a490571751a86cf76d2ff07cefb4c380881f72640a6d87b0eeea,218,431761,1689aeaebcd6a490571751a86cf76d2ff07cefb4c380881f72640a6d87b0eeea,218,430871,890,4.08
507,90928bfc9952c67efe8b7319f8a39a1eb29fe916aec05004e0824d83ad236ba4,191,120771290,90928bfc9952c67efe8b7319f8a39a1eb29fe916aec05004e0824d83ad236ba4,191,120576980,194310,1017.33
508,f5f5f443c424120d842ca90d96856f4ec1bbdba404c5ecfb7695d9a727e0f3f4,222,605844,f5f5f443c424120d842ca90d96856f4ec1bbdba404c5ecfb7695d9a727e0f3f4,222,598485,7359,33.15
509,163d9b78c7f53def943683586602f3a1431c4243281f96a5736c847d7df58001,8925,62891630,163d9b78c7f53def943683586602f3a1431c4243281f96a5736c847d7df58001,8925,62739446,152184,17.05
510,07a4c9054c9f038c5e99cab10b421d77fee1248d04a984d028e29ffbb1a00add,405,351508,07a4c9054c9f038c5e99cab10b421d77fee1248d04a984d028e29ffbb1a00add,405,351191,317,0.78
511,39e8e1465c19e6c16f8a13462f9809da1ea81cee9c6efaf40372f77630081d66,339,551903,39e8e1465c19e6c16f8a13462f9809da1ea81cee9c6efaf40372f77630081d66,339,550000,1903,5.61
512,d7bdb2033e4d660399d25ac47cee9163ce93d4c2e7f54750e151e6e94723df9a,1365,2661264,d7bdb2033e4d660399d25ac47cee9163ce93d4c2e7f54750e151e6e94723df9a,1365,2646128,15136,11.09
